Port Elizabeth	city in the Eastern Cape, South Africa
Cape Town	city in the Western Cape, South Africa
Seventh-day Adventist Church	Christian church
Metz	commune in Moselle, France
Cajun	ethnic group mainly living in the U.S. state of Louisiana
Kiev	capital and the largest city of Ukraine
Pomeranian Voivodeship	voivodeship of Poland
Tijuana	largest city and municipal seat in Baja California, Mexico
Ticino	canton of Switzerland
Tripoli	capital city of Libya
Mecca	Saudi Arabian city and capital of the Makkah province
Transylvania	historical region in the northwestern part of Romania
Padua	capital of the province Padua, Veneto, Italy
Papua New Guinea	republic in Oceania
Pacific Ocean	largest ocean on Earth
West Bank	part of the Palestinian territories near the Mediterranean coast of Western Asia
German Empire	German nation state that existed from the Unification of Germany in 1871 until the abdication of Kaiser Wilhelm II in 1918
Valletta	capital of Malta
Vaucluse	French department
Kumasi	second largest city of Ghana
Atlantic Ocean	ocean on Earth
Calabria	region in Italy
Uzbekistan	republic in Central Asia
Equatorial Guinea	country in Africa
French Republic	republic governing France, 1792-1804
Baku	capital of Azerbaijan
Brazil	federal republic in South America
marriage	social union or legal contract between people called spouses that creates kinship
Dalian	sub-provincial city in Liaoning, China
Alps	one of the great mountain range systems of Europe
Brunei	country in Asia
Yvelines	French department
Umbria	region of Italy
Filipino American	ethnic group
Church of Scotland	national church in Scotland
Bahrain	constitutional monarchy in Southwest Asia
First French Empire	empire of Napoleon I of France between 1804-1815
Yerevan	capital of Armenia
Bohemia	Historical land in the Czech Republic
Portugal	republic in Southwestern Europe
Aruba	island country in the Caribbean, part of the Kingdom of the Netherlands
Boulogne-Billancourt	commune in Hauts-de-Seine, France
African Development Bank	multilateral development finance institution
Norway	constitutional monarchy in Northern Europe
Parma	Italian comune
Holy Roman Emperor	emperor of the Holy Roman Empire
Peru	republic in South America
French Third Republic	nation of  France from 1870 to 1940
Yugoslavia	former country in Southeast Europe
Christianity	monotheistic religion founded in the first century
Ireland	island in north-west Europe, currently politically divided into the Republic of Ireland and Northern Ireland
Irish migration to Great Britain	No description defined
Odense	city in Denmark
Tampere	city in the region of Pirkanmaa in Finland
Indian Ocean	ocean between Africa, Asia, Oceania and Antartica
Helsingborg	urban area in Helsingborg Municipality, Sweden
Kingdom of Italy	kingdom on the Appenine Peninsula between 1861 and 1946
Bengali people	ethnic group native to India and Bangladesh
Eurasia	continental landmass comprising Europe and Asia
Crete	island of Greece
Suriname	country in South America
Boxer Rebellion	anti-imperialist uprising which took place in China
Catania	Italian city on the east coast of Sicily
University of Turin	university in Turin, Italy
Monaco	principality in Western Europe
Venice	city in northeastern Italy, sited on a group of 118 small islands
Catalonia	autonomous community of Spain
Caracas	capital of Venezuela
Jiangsu	Province of China
Eastern Orthodox Church	religious denomination
Nondenominational Christianity	No description defined
Accra	capital city of Ghana
Malawi	country in Africa
Republic of the Congo	country in Africa
European Union	economic and political union of states mostly located in Europe
Bandung	Capital of West Java province in Indonesia
Nepal	country in South Asia located between India and China
Seville	city in the province of Seville, Spain
Middle East	region that encompasses majority of Western Asia and Egypt
Brescia	Italian city in Lombardy
Iraq	republic in Western Asia
Moscow	capital city and the largest city of Russia; separate federal subject of Russia
Catholicism	broad term for beliefs associated with several Christian churches
Cape Verde	country comprising ten islands off the Western coast of Africa
Marche	region in Italy
Switzerland	federal republic in Western Europe
Sofia	capital city of Bulgaria
Confederate States of America	(de facto) federal republic in North America from 1861 to 1865
Azerbaijan	republic in Western Asia and Eastern Europe
Jamaica	country in the Caribbean
KwaZulu-Natal	province of South Africa
Welsh people	nation and ethnic group native to Wales
Japanese people	ethnic group native to Japan
Basilicata	region of Italy
Dnipro	city in Ukraine
Greek American	ethnic group
Western Cape	province of South Africa
Council of Europe	international organization
Split	city in Split-Dalmatia County, Croatia
common-law marriage	No description defined
Zaragoza	city of Aragon, Spain
Rio de Janeiro	city in Rio de Janeiro federated state, Brazil
Lower Normandy	former administrative region of France
Moldavia	medieval principality (nowadays historical and geographical region in Romania, Moldova, and Ukraine)
Santiago	capital city of Chile
silent film	film with no synchronized recorded sound
People's Republic of China	state in East Asia
North America	continent on the Earth's northern hemisphere
Reims	city in Marne, France
Piedmont	region in North-West Italy
Wuhan	capital city of Hubei Province, China
Library of Congress Classification	classification
North Vietnam	former country
Mexico	federal republic in the southern portion of North America
Italian American	United States citizens of Italian ancestry
Como	Italian city
Madrid	capital city of Spain
Kharkiv	city of Ukraine
Second Polish Republic	1918-1939 republic in Eastern Europe
Kazan	city in the Republic of Tatarstan, Russia
Guangdong	province of China
Changsha	capital of Hunan province, China
Kenya	republic in East Africa
Athens	capital city of Greece
Saint Petersburg	federal city in Russia and the former capital
Lund	urban area in Lund Municipality, Sweden
South Korea	republic in East Asia
New Zealand	constitutional monarchy in Oceania
The University of Hong Kong	university in Hong Kong
Casablanca	city in Morocco
Hungary	republic in Central-Eastern Europe
Trentino	autonomous province of Italy
Perugia	Italian comune
Dutch American	ethnic group
Guinea	country in Africa
Roundhead	name given to the supporters of the Parliament during the English Civil War
Turku	city in the region of Finland Proper, Finland
Indian rupee	currency of India
cavalier	royalist supporter during and following the English Civil War
Hinduism	religion and way of life
French American	ethnic group
Javanese people	Javanese people are an ethnic group native to the Indonesian island of Java.
Ghana	country in West Africa
Versailles	commune in Yvelines, France
Eastern Catholic Church	autonomous, self-governing particular Churches in full communion with the Pope
atheism	rejection of belief in the existence of deities
Yunnan	Province of China
Baghdad	capital of Iraq
Hebei	province of China
Pyongyang	capital of North Korea
Spanish Empire	one of the largest empires in world history, most  powerful from the 16th until 18th century
Geneva	city in Switzerland and capital of its canton
Turin	city and commune in Italy
Puerto Rican people	ethnic group
Dominion of New Zealand	former dominion of the British Empire
United States dollar	currency of the United States of America
Carthage	historical Carthage city
Province of Palermo	province of Italy
Senegal	country in Western Africa
Turkey	country spanning Southeastern Europe and Western Asia
Tirana	capital city of Albania
Canada	country in North America
Calvinism	Protestant branch of Christianity
Faroe Islands	island group and archipelago
Eastern Cape	province of South Africa
Colombia	country in South America
Jerusalem	ancient holy city in the Judean Mountains
Lombardy	administrative region in Northern Italy
Sichuan	province of China
Bible	collection of sacred books in Judaism and Christianity
Montmartre Cemetery	cemetery located in Paris, in France
Filipino people	people native or citizens of the islands of the Philippines
Mongol Empire	former country in Asia and Europe
Djibouti	country in Africa
Katowice	city in Silesian Voivodeship, Poland
Malta	island republic in Europe
Botswana	country in Africa
Picardy	former administrative region of France
Croatia	republic in Southeast Europe
Province of Naples	former province in Italy
Asian American	ethnic group
Hindu	adherent of Hinduism
Province of Salerno	province of Italy
Kingdom of Romania	kingdom in Southeastern Europe between 1881 and 1947
West Germany	former republic in central-western Europe between 1949-1990
Bulgaria	country in Eastern Europe
Gambia	country in West Africa
Lazio	one of the twenty administrative regions of Italy
Buenos Aires	capital city of Argentina
Uppsala	city in Uppsala County, Sweden
labor rights	No description defined
Kuwait City	capital of Kuwait
Helsinki	city in Uusimaa, Finland and capital of Finland
Taras Shevchenko National University of Kyiv	university
Sri Lanka	country in South Asia
Namibia	country in Africa
Haifa	city in Israel
University of Bologna	university in Bologna, Italy
Organization for Economic Co-operation and Development	international economic organisation
Dominica	country in the Caribbean
Zagreb	capital city of Croatia
Evangelicalism	movement within Protestant Christianity
World Bank	international financial institution
German American	ethnic group
Nauru	republic in Oceania
Guangzhou	capital city of Guangdong Province, China
Lublin Voivodeship	in Poland
Damascus	capital of Syria
Podlaskie Voivodeship	voivodeship of Poland
Cremona	Italian city in Lombardy
Freetown	capital of Sierra Leone
Aboriginal Australians	legal term used by the English and Australian administrations to refer to Indigenous Australians
Wallachia	historical and geographical region of Romania
Byzantine Empire	Roman Empire during Late Antiquity and the Middle Ages
Zhejiang	province of China
Havana	capital city and commercial centre of Cuba
Maldives	country in Asia
United Church of Christ	Protestant Christian denomination
South Africa	republic in Southern Africa
Valencia	city in Spain
Scotland	country in North-West Europe, part of the United Kingdom
Saint Kitts and Nevis	country in Central America and Caribbean
Szczecin	capital city of the West Pomeranian Voivodeship, Poland.
Names of the Greeks	clemorisa
Wellington	capital city of New Zealand
English people	nation and ethnic group native to England
Apache	several culturally related groups of Native Americans in the United States
Lorraine	cultural region in France
Manche	French department
Ravenna	Italian comune
Nigeria	country in West Africa
Kampala	capital of Uganda
Mormonism	religious tradition of Mormons
Federated States of Micronesia	country in Oceania
Harare	capital of Zimbabwe
Palestinian National Authority	interim government in Western Asia, governing West Bank Areas A and B since 1994 and, until 2006, the Gaza Strip
Dordogne	French department
Axis	alliance of countries defeated in World War 2
Australians	ethnic group
Zimbabwe	country in Africa
Ankara	capital of Turkey
Saint Lucia	country in the Caribbean
Neuilly-sur-Seine	commune in Hauts-de-Seine, France
Province of Como	province of Italy
Eritrea	country in the Horn of Africa
sea	large body of saline water
Ian Bannen	Scottish character actor and occasional leading man
Kingdom of Bulgaria	Kingdom on the Balkan Peninsula between 1908 and 1946
domestic partnership	relationship between two people who live together but are not married
Pennine Alps	mountain range in the Western part of the Alps
Ukraine	country in Eastern Europe
republic	system of government where the state's sovereignty does not rest in an individual
Toledo	municipality in central Spain
Philippines	republic in Southeast Asia
Sarajevo	capital city of Bosnia and Herzegovina
Port of Spain	capital of Trinidad and Tobago
Cuban American	ethnic group
Mary	religious figure and mother of Jesus of Nazereth
Makerere University	university in  Kampala, Uganda
Province of Potenza	province of Italy
Liaoning	province of China
Iceland	island republic in Northern Europe
Bern	capital of Switzerland and municipality in the canton of Bern
Italy	Republic in Southern Europe
Abyssinia	1137-1974 empire in East Africa
Spain	constitutional monarchy in Southwest Europe
Mogadishu	capital of Somalia
Vatican City	country in southern Europe under the sovereignty of the Holy See
British Indian	British citizens with Indian ancestry
Avignon	commune in Vaucluse, France
Mongolia	country in East Asia, between China and Russia
Armenia	republic in Western Asia
Argentina	federal republic in South America
African Union	supranational union
Tibet	plateau region in Asia
Hispanic	people of or descended from a Spanish-speaking culture
Zambia	country in Africa
Laos	republic in Southeast Asia
Henan	province of China
Greek Orthodox Church	Orthodox Christian denominations descended from a Greek cultural tradition
Cherokee	Native American people indigenous to the Southeastern United States
region of Kyrgyzstan	No description defined
Aegean Sea	part of the Mediterranean Sea
Baptist	denomination of Protestant Christianity
United States of America	federal republic in North America
Republic of Macedonia	republic in Southeast Europe
Johor	Malaysian state
Rabat	capital of Morocco
English American	ethnic group
Copenhagen	capital city of Denmark
Aude	department in south-central France named after the river Aude
Haut-Rhin	French department
British Virgin Islands	British overseas territory
American Jews	ethnic group
Palermo	Italian comune
Ljubljana	capital city of Slovenia
Pavia	Italian comune
Liechtenstein	principality in Central Europe
Protestantism	division within Christianity
Ivory Coast	country in Africa
Niger	country in Western Africa
Mali	country in Africa
Iberian Peninsula	peninsula located in the extreme southwest of Europe
Latin America	region of the Americas where Romance languages are primarily spoken
Antwerp	city in the province of Antwerp, Belgium
Irish American	ethnic group
presidential system	form of government
Russians	East Slavic ethnic group, regardless of country of citizenship
Sioux	Native American and First Nations people in North America
North Africa	northernmost region of the African continent
Episcopal Church	Anglican denomination in the United States
Tajikistan	republic in Central Asia
Odessa	city in Ukraine, the administrative center of the Odessa Oblast
Ecuador	country in South America
Bari	Italian city, capital of the Apulia region
Buddhism	religion founded by Buddha
Julius Caesar	Roman politician and general
Florence	Italian city, located in Tuscany
Kingdom of Scotland	historic sovereign kingdom on the British Isles from the 9th century and up to 1707
Medina	Saudi Arabian city
Abruzzo	region in Italy
Lucca	Italian comune
Burundi	country in Africa
Basel	city on the Rhine, in Switzerland
Mexican American	Americans of Mexican heritage
Province of Turin	ex province of Italy. now Metropolitan City of Turin (Q18288162)
Campania	region in Southern Italy
Commonwealth of Nations	intergovernmental organisation
Finland	country in Northern Europe
British Raj	British rule in the Indian subcontinent, 1858-1947
Bloemfontein	city in the Free State, South Africa
Cyprus	country in Southern Europe
Spaniards	people native to any part of Spain or that hold Spanish citizenship
strongman	competitor in strength athletics
Presbyterianism	branch of Protestant Christianity using presbyterian church government and originating in the British Isles
Livorno	city in Italy
Saint Vincent and the Grenadines	country in the Caribbean
Harbin	capital of Heilongjiang province, China
Cambodia	constitutional monarchy in Southeast Asia
Canadian dollar	currency of Canada
United Arab Emirates	monarchy in Southwest Asia
Scientology	Cult-like body of beliefs and related practices created by science fiction writer L. Ron Hubbard
Rome	capital city of Italy
Uganda	republic in Central Africa
Riyadh	capital of Saudi Arabia
Calvados	French department
Costa Rica	country in Central America
Suzhou	prefecture-level city in Jiangsu, China
Shanxi	province of China
El Salvador	country in Central America
Early modern France	No description defined
Caribbean Sea	sea of the Atlantic Ocean bounded by North, Central, and South America
Barcelona Province	province in Spain
The Patriot	colonist who rebelled against British control in the American Revolution
Caribbean	region in Central America composed of many islands and countries on the surrounding coast
Belize	country in Central America
Benin	country in Africa
Iroquois	northeast Native American people
Nantes	commune in Loire-Atlantique, France
Isfahan	capital of Isfahan Province in Iran
Austrians	nation and an ethnic group of people living in Austria
Tamil people	ethnic group
Southeast Asia	subregion of Asia
Greenland	island located between the Arctic Ocean and the North Atlantic Ocean
Europe	continent in Earth's Northern Hemisphere
Bhangra	upbeat type of popular music associated with Punjabi culture
Belarus	a country in Eastern Europe
Napoleon	French monarch, military and political leader
Bergamo	Italian comune
Cuba	island country in the Caribbean
Nicaragua	country in Central America
United Kingdom	country in Europe
Turks and Caicos Islands	British Overseas Territory
Yemen	country in Western Asia
Trinidad and Tobago	island country in the Caribbean Sea
Pakistan	republic in Asia
Lyon	commune in the metropolis of Lyon, France
Morocco	country in North Africa
Cook Islands	country in the South Pacific Ocean
Art Nouveau	international philosophy and style of art, architecture and applied art
National Front for the Liberation of South Vietnam	political organization with its own army
Belo Horizonte	city in Brazil
Armenians	ethnic group native to the Armenian Highland
Kaunas	city in Lithuania
South Sudan	country in Africa
paganism	non-Abrahamic religion, or modern religious movement such as nature worship
Bosnia and Herzegovina	republic in Southeast Europe
France	country with territory in Europe and several overseas regions and territories
Swedish Empire	former country
Innsbruck	federated state capital of Tyrol, Austria
Beijing	capital city of China
Earth	third planet from the Sun in the Solar System
Tonga	country in Oceania
English Channel	arm of the Atlantic Ocean that separates southern England from northern France
Germans	citizens or native-born people of Germany; or people of descent to the ethnic and ethnolinguistic group associated with the German language
warlord	person with power who has both military and civil control
Union of South Africa	state in southern Africa from 1910 to 1961, predecessor to the Republic of South Africa
Fujian	province of China
Hungarian people	ethnic group and nation
Hunan	province of China
Burgundy	former administrative region of France
Trinidad	larger of the two major islands which make up Trinidad and Tobago
Veneto	region in Italy
Caen	commune in Calvados, France
Pretoria	capital city of South Africa
Asian Development Bank	regional development bank
Italians	nation and ethnic group native to Italy
Bratislava	capital city of Slovakia
Nord	French department
Macau	Special Administrative Region of China
Adriatic Sea	body of water
Pietermaritzburg	city in KwaZulu-Natal, South Africa
The Bahamas	country in North America
Guam	unincorporated United States territory in the western Pacific Ocean
Swedes	nation and ethnic group native to Sweden
French Polynesia	French overseas country in the Southern Pacific ocean
Pisa	city in Tuscany, Central Italy
Methodism	group of historically related denominations of Protestant Christianity
Ho Chi Minh City	largest city in Vietnam
Addis Ababa	capital city of Ethiopia
Euro	European currency
Central African Republic	country in Africa
Upper Austria	state of Austria
Andes	mountain range running along the Western side of The Americas
League of Nations	intergovernmental organization, predecessor to the United Nations
Thessaloniki	city of Greece
British Isles	group of islands in northwest Europe
Solomon Islands	country in Oceania
Rio Grande do Sul	state of Brazil
Vojvodina	autonomous province of Serbia
Lesotho	kingdom in southern Africa
Southern Baptist Convention	No description defined
Algeria	country in North Africa
Kandy	city in Central Province, Sri Lanka
Treviso	Italian comune
Orange Free State	independent Boer sovereign republic in southern Africa
Barbados	country in the Caribbean
Bangladesh	country in South Asia
parliamentary monarchy	No description defined
Acadians	descendants of the 17th-century French colonists who settled in Acadia
Bas-Rhin	French department
Asia	continent, mainly on the Earth's Eastern Hemisphere
Paris	capital city of France
Ethiopia	country in Africa
Province of Cagliari	province of Italy
Moldova	republic in Eastern Europe
Augustus	founder of Julio-Claudian dynasty and first emperor of the Roman Empire
Nord-Pas-de-Calais	former administrative region of France
Roman Republic	period of ancient Roman civilization (509 BC-27 BC)
Saudi Arabia	kingdom in Western Asia
Lisbon	capital city of Portugal
Shaanxi	province of China
San Marino	republic on the Appenine peninsula
Belgium	federal constitutional monarchy in Western Europe
University of Ghana	first university of Ghana
Georgia	country in Eastern Europe
Tel Aviv	second largest city in Israel
Chongqing	municipality in China
Polish American	ethnic group
Russia	transcontinental country in Eastern Europe and Northern Asia
Tours	commune in Indre-et-Loire, France
Tbilisi	capital city of Georgia
Christian	person who adheres to Christianity
Canton of Valais	canton of Switzerland
Grenada	country in the Caribbean
Xinjiang	autonomous region of China
asteroid	minor planet that is not comet
Lausanne	capital city of the Swiss Canton of Vaud
United Nations	intergovernmental organisation
North Korea	country in East Asia
igneous rock	one of the three main rock types; formed through the cooling and solidification of magma or lava
Socialist Federal Republic of Yugoslavia	socialist republic in Southeast Europe between 1943 and 1992
democracy	system of government in which citizens elect representatives to form a governing body, sometimes called "rule of the majority"
Guernsey	British Crown dependency comprised of several islands
Croatian American	ethnic group
Russian Americans	Americans who trace their ancestry to Russia
Guyana	country in South America
Sweden	constitutional monarchy in Northern Europe
Stavanger	city and municipality in Rogaland, Norway
Naples	city in Campania, Italy
Indonesia	republic in Southeast Asia
Gabon	country in Africa
Toulouse	commune in Haute-Garonne, France
Morning Musume	Japanese girl group
Irish people	ethnic group
Trieste	city and seaport in northeastern Italy
Shia Islam	denomination of Islam
Australian dollar	official currency used in Australia
Paramaribo	capital of Suriname
Nassau	capital city of the Commonwealth of the Bahamas
Libya	country in north Africa
Seine-et-Marne	French department
North Atlantic Treaty Organisation	intergovernmental military alliance of Western states
Haute-Savoie	French department
Dominican Republic	country in the Caribbean
Tianjin	Municipality in China
East Timor	country in South East Asia
Overseas Chinese	ethnic group
Emilia-Romagna	region in Italy
Chinese American	ethnic group
Kaohsiung City	special municipality under the administration of Taiwan
parliamentary system	form of government
Taipei	capital of Taiwan
Academy of Motion Picture Arts and Sciences	professional honorary organization
Anguilla	British Overseas Territory in the Caribbean
Skopje	capital city of the Republic of Macedonia
Sapienza University of Rome	Italian university founded in Rome in 1303
Belgrade	capital of Serbia
Antilles	Caribbean islands
Somalia	country in Africa
Singapore	republic in Southeast Asia
Kathmandu	capital of Nepal
Luxembourg	grand duchy in Western Europe
Ukrainians	East Slavic ethnic group native to Ukraine
Messina	Italian comune in Sicily
World Trade Organization	organization that intends to supervise and liberalize international trade
Kiribati	island nation in the central Pacific Ocean
Poles	people from Poland
Bologna	city in Emilia-Romagna, Italy
Churches of Christ	autonomous Christian congregations
Modena	Italian city and comune
Lille	commune in Nord, France
Apulia	region of Italy
Mediterranean Sea	sea connected to the Atlantic Ocean surrounded by the Mediterranean region
Jainism	ancient religion that originated in India
White British	ethnicity classification used in the 2011 United Kingdom Census
Federation of Bosnia and Herzegovina	political entity of the sovereign country of Bosnia and Herzegovina
Shanghai	city in the People's Republic of China
Aquitaine	former administrative region in France
Minsk	capital city of Belarus
Comoros	sovereign archipelago island nation in the Indian Ocean
Lviv	city in western Ukraine
Fiji	country in Oceania
Blessed Virgin Mary	Roman Catholic veneration of Mary
Lower Austria	federated state of Austria
Africa	continent on the Earth's northern and southern hemispheres
Styria	federated state in Austria
Sufi Islam	denomination of Islam
Himalayas	mountain range in Central Asia
Bulawayo	City in Zimbabwe
Koreans	people based in the Korean Peninsula and Manchuria
Brittany	administrative region of France
Greater Poland Voivodeship	voivodeship of Poland
Thai Chinese	No description defined
Dutch Republic	republic in Europe existing from 1581 to 1795
preacher	person who delivers sermons or gives homilies
Korea	historic country in East Asia
Mauritius	island nation in the Indian Ocean
Paraguay	country in South America
Barcelona	capital of Catalonia and second largest city in Spain
Kensal Green Cemetery	cemetery in Kensal Green, in the west of London, England
Tunisia	country in northern Africa
Thailand	constitutional monarchy in Southeast Asia
South Tyrol	autonomous province of Italy
Great Britain	island in the North Atlantic off the north-west coast of continental Europe
Pontifical Gregorian University	pontifical university located in Rome, Italy
East Germany	former communist country, 1949-1990
Languedoc-Roussillon	former administrative region of France
Vicenza	Italian comune
Russian Orthodox Church	autocephalous Orthodox Christian church, the largest autocephalous Orthodox church in the world
congregational church	religious denomination
Czech Republic	republic in Europe
Theravada	branch of Buddhism
world	planet Earth and all life upon it, including human civilization
Tyrol	federal state in western Austria
Ferrara	Italian comune
Sicily	island in the Mediterranean Sea
Japan	constitutional monarchy in East Asia
Israel	country in Western Asia
Shandong	province of China
Hanoi	capital of Vietnam
Amman	capital of Jordan
Myanmar	country in Southeast Asia
Emirate of Dubai	one of the seven emirates of the United Arab Emirates
Ottoman Empire	former empire in Asia, Europe and Africa
Vilnius	capital of Lithuania
Palau	republic in Oceania
Porto	second-largest city in Portugal
Rwanda	country in Africa
Dakar	capital of Senegal
Quito	capital of Ecuador
Corsica	territorial collectivity of France
Academy Awards	awards given annually for excellence of cinematic achievements
Antigua and Barbuda	country in the Caribbean
Mauritania	country in Africa
Slovenia	republic in Central-Eastern-Southern Europe
Panama	republic in Central America
Province of Milan	province in the Lombardy region, Italy
Durban	city in KwaZulu-Natal, South Africa
Australia	country in Oceania
Montevideo	capital city of Uruguay
Festival Records	No description defined
Nanjing	capital of Jiangsu province in Eastern China
Religious Society of Friends	family of religious movements
Leuven	city in Flemish Brabant, Belgium
Falkland Islands	archipelago in the South Atlantic Ocean
Togo	country in Africa
Budapest	capital city of Hungary
Sri Lankan Tamil people	No description defined
Cayman Islands	British Overseas Territory in the western Caribbean Sea, which comprises the three islands of Grand Cayman, Cayman Brac and Little Cayman, located south of Cuba and northwest of Jamaica
volcano	natural, surface vent or fissure usually in a mountainous form
Milan	second-largest city in Italy
Strasbourg	commune in Bas-Rhin, France
Sparta	city-state in ancient Greece
Province of Rome	former province in the Lazio region of Italy
Kingston	capital of Jamaica
Siena	Italian comune
Oman	country in Western Asia
Lesser Antilles	island arc in the Caribbean Sea
Verona	city in Veneto, northern Italy
Tuvalu	country in Oceania
Romani people	ethnic group living mostly in Europe and the Americas
Lutheranism	branch of Protestantism based on the teachings of Martin Luther
Sardinia	region of Italy
White American	people of the United States who are considered or consider themselves White
Weimar Republic	Germany in the years 1918/1919-1933
Ukrainian Soviet Socialist Republic	one of fifteen constituent republics of the Soviet Union (USSR); founding member of the United Nations Organization in 1945
Chad	country in central Africa
Chile	republic in South America
Bruges	city in West Flanders, Belgium
Serbia	republic in Southeastern Europe
Madagascar	country in the Indian Ocean, off the coast of Southeast Africa
United Methodist Church	Methodist-Christian denomination that is both mainline Protestant and Evangelical
Kazakhstan	republic in Central Asia
Aisne	French department
Istanbul	largest city in Turkey
Seychelles	island country to the East of Africa
Jewish	nation and an ethnoreligious group
French people	nation and ethnic group who are identified with the country of France
Punjabi people	ethnic group
Mantua	Italian comune
Israelis	ethnic group
Swedish American	American of Swedish descent
Chinese Filipino	No description defined
Oriental Orthodoxy	branch of Eastern Christianity
Salzburg	city in Salzburg federated state, Austria
Salvador	city in the state of Bahia, Brazil
Latvia	republic in Northeastern Europe
Electorate of Saxony	State of the Holy Roman Empire, established when Emperor Charles IV raised the Ascanian duchy of Saxe-Wittenberg to the status of an Electorate 1356
Jordan	constitutional monarchy in Western Asia
Vanuatu	country in Oceania
Oslo	capital city and county in Norway
New Caledonia	overseas territory of France in the southwest Pacific Ocean
Anhui	province of China
Sikhism	Indian religion founded by Guru Nanak
Lagos	city in Nigeria
Scottish American	ethnic group
Symbolism	art movement
Mozambique	country in Africa
Cannes	commune in Alpes-Maritimes, France
Pyrenees	range of mountains in southwest Europe
Romania	republic in Southeast Europe
Upper Normandy	former administrative region of France
Syria	republic in Western Asia
Denmark	sovereign state and Scandinavian country in northern Europe
Malayali	ethnic group
African, Caribbean and Pacific Group of States	No description defined
Vietnam	republic in Southeast Asia
Nice	commune in Alpes-Maritimes, France
South Vietnam	country in southeast Asia
Douala	city in Cameroon
India	federal republic in Asia
Liguria	Italian region
Liberia	republic in West Africa
Genoa	Italian city
Pentecostalism	renewal movement within Protestant Christianity
pound sterling	official currency of the United Kingdom and other territories
Frederick II of Prussia	king of Prussia
Kingdom of Greece	kingdom in Southern Europe during the 19th and 20th century
Monza	Italian comune
Norwegians	people
Minas Gerais	state of Brazil
Alpes-Maritimes	French department
Austria	federal republic in Central Europe
Iran	Islamic Republic in Western Asia
Graz	city in Styria, Austria
Oceania	continent or geographical region in and near the Pacific Ocean
Tashkent	capital of Uzbekistan
Champagne-Ardenne	former administrative region in France
American Samoa	US territory in the Pacific
Kinshasa	capital city of the Democratic Republic of the Congo
B movie	film genre
Indian people	ethnic group
Andorra	European microstate between France and Spain
Bilbao	municipality and city in Spain
Yangon	former capital of Burma (Myanmar) and the capital of Yangon Region
Qingdao	prefecture-level city in Shandong, China
Canton of Bern	canton of Switzerland
Crimean Astrophysical Observatory	observatory
Nancy	commune in Meurthe-et-Moselle, France
Louvre	art and archeology museum in Paris, France
Hong Kong	Special Administrative Region of China
Aleppo	city and governorate capital of Aleppo, Syria
Greece	republic in Southern Europe
Crimean Peninsula	peninsula in the Black Sea
Jeddah	city in western Saudi Arabia
Germany	country in central Europe
Guatemala	republic in Central America
Bhutan	country in South Asia
North Sea	sea in Europe
Lebanese American	No description defined
Albania	republic in Southeast Europe
Afghanistan	republic in South Asia
Austria-Hungary	constitutional monarchic union  from 1867 to October 1918
Haiti	country in the Caribbean
Uruguay	republic in South America
Province of Brescia	province of Italy
Danube	river in Central Europe
Turkmenistan	republic in Central Asia
West Java Province	province of Indonesia on Java island
Sikh	ethnic group
Swaziland	country in Africa
Catholic Church	Christian church led by the Pope, consisting of the Latin Church and 23 Eastern Catholic Churches
unitary state	state governed as a single unit with a supreme central government
Ashkenazi Jews	ethnic group
Stockholm	capital of Sweden
Lesser Poland Voivodeship	Voivodeship of Poland.
Burkina Faso	country in Africa
Church of England	Christian church in England and the Mother Church of the worldwide Anglican Communion
Warsaw	capital and largest city of Poland
East Prussia	province of Prussia
Midwest hip hop	No description defined
Porto Alegre	capital and largest city in the Brazilian state of Rio Grande do Sul
Lithuania	republic in Northeastern Europe
Isle of Man	British Crown Dependency
Moscow Oblast	federal subject of Russia
Hubei	Province of China
Montenegro	country in Europe
Pashtun people	Iranic ethnic group belonging to Afghanistan and Pakistan
Gothenburg	locality in Gothenburg Municipality, Sweden
Somme	French department
Canton of Vaud	canton of Switzerland
Jersey	British Crown Dependency in the Channel Islands
House of Plantagenet	royal dynasty
Tunis	capital city of Tunisia
Saudi arabia	country in Africa
Habsburg Empire	former Central European country (1526-1804)
Cameroon	country in Central Africa
Unitarianism	liberal Protestant movement later merged with Universalism
Alsace	former administrative region and former province of France
Judaism	religion of the Jewish people
Kingdom of Portugal	kingdom in Southwestern Europe between 1139 and 1910
palazzo	type of palatial building in Italy
Tuscany	region of Italy
Bordeaux	commune in Gironde, France
Bermuda	British overseas territory
Tanzania	country in Africa
Qatar	country in western Asia
Bolivia	country in South America
Egypt	republic in North Africa
Unitarian Universalism	liberal religion
Yekaterinburg	Russian city
Honduras	republic in Central America
Malaysia	federal constitutional monarchy in Southeast Asia
Kuwait	emirate in Western Asia
Dutch people	ethnic group
Hangzhou	capital of Zhejiang Province, China
Normandy	historical province and cultural region now in France and the Channel Islands
Indian American	Americans of Indian ancestry
Samoa	country in Oceania
Angola	country in Africa
Santo Domingo	capital of the Dominican Republic
Lebanon	republic in Western Asia
Espoo	city in the region of Uusimaa in Finland
African Americans	ethnic group of Americans
Poitou-Charentes	former administrative region of France
Gibraltar	British Overseas Territory
Poland	republic in Central-Eastern Europe
