iron	chemical element 26 or simple substance composed thereof
afrobeat	musical genre
stop-motion	animation technique to make a physically manipulated object appear to move on its own
House of Habsburg	Austrian dynastic family
single-player video game	computer- or video game that only permits one player
Daegu	city in South Korea
satire	genre
Aichi Prefecture	prefecture of Japan
Neftchi Baku PFC	association football club
biographical film	film genre; dramatizes the life of an actual person or people
1998 Major League Baseball season	No description defined
delicatessen	shop selling cured meats and sausages, expensive cheeses, caviar, or luxury confectionery
Cichlidae	family of fishes
Kolkata	capital city of West Bengal, India
cerebrospinal fluid	clear colorless bodily fluid found in the brain and spine
structured programming	programming paradigm aimed at improving clarity, quality, and development time by using control structures
Italian cuisine	national foods and preparation
Kansai region	region in Japan
old-growth forest	forest that has attained great age without significant disturbance
Fukuoka	capital city of Fukuoka Prefecture, Japan
nonprofit organization	organization that uses its income to achieve its goals rather than distributing it as profit or dividends
December	twelfth month in the Julian and Gregorian calendars
Werner Stengel	German roller coaster designer
June	sixth month in the Julian and Gregorian calendars
July	seventh month in the Julian and Gregorian calendars
Communist Party of Germany	former political party in Germany
situation comedy	genre of comedy
Florida Keys	coral cay archipelago in Florida, United States of America
epic film	film genre
folic acid	chemical compound
romance film	film genre
English Renaissance	No description defined
thiamine ion	chemical compound
mercenary	soldier who fights for hire
cholesterol	sterol (or modified steroid),[4] a type of lipid molecule, and is biosynthesized by all animal cells, because it is an essential structural component of all animal cell membranes
House of Romanov	imperial dynasty of Russia
detective	investigator, either a member of a police agency or a private person
ancient Greece	civilization belonging to a period of Greek history
Victorian architecture	series of architectural revival styles
2009 World Championships in Athletics	2009 edition of the World Championships in Athletics
Andhra Pradesh	Indian state
L-Phenylalanine	chemical compound
Clyde F.C.	association football club
Canadian Alliance	political party
Vitamin A	vitamin, class of molecules with related biological function
aerospace	engineering effort to fly in the atmosphere of Earth (aeronautics) and surrounding space (astronautics)
Nazi Party	political party in Germany between 1920 and 1945
musical keyboard	musical instrument part
New York Shipbuilding Corporation	shipbuilding company
Liliaceae	family of plants
Socialist Unity Party of Germany	Marxist-Leninist political party and ruling state party of the GDR
fast food	food prepared and served in a small amount of time
Himachal Pradesh	Indian state
Sikkim	Indian state
People's Democratic Party	Political party in Nigeria
sugar	disaccharide formed by a molecule of glucose and one of fructose
2011 Sundance Film Festival	2011 film festival edition
Thrissur	Town in Kerala, India
Chulalongkorn	King of Siam
conglomerate	two or more corporations that fall under one corporate group
Gothic Revival architecture	architectural movement
University of Karachi	No description defined
asteroid belt	the circumstellar disk (accumulation of matter) in an orbit between those of Mars and Jupiter
dance film	film in which dance is a central element in the narrative
RCD Espanyol B	football club based in Barcelona, in the autonomous community of Catalonia, Spain
clothing	covering worn on the human body
County Clare	county in Ireland
Varanasi	city on the banks of the Ganges in the Uttar Pradesh state of India
Green Party of the United States	American political party
Kyoto University	national university located in Kyoto, Japan
public university	university that is predominantly funded by public means
Indonesian cuisine	No description defined
Art Deco	influential visual arts design style which first appeared in France during the 1920s
Conservative Party of Canada	Canadian political party active under various names from 1854 to 1942
K-pop	musical genre originating in South Korea
docudrama	documentary genre that features dramatized re-enactments of actual events
manufacturing	industrial activity producing goods for sale using labor and machines
gay	term that primarily refers to a homosexual person
Kyoto	city in Japan
AIK Fotboll	association football club in Solna, Sweden
financier	person who makes their living from investments
tyrosine	amino acid
fighting game	video game genre
astronaut	person who commands, pilots, or serves as a crew member of a spacecraft
Adolphe Menjou	American actor
human rights	inalienable fundamental rights to which a person is inherently entitled
Islamabad	capital city of Pakistan
Ludhiana	city in Punjab, India
Haskell	functional programming language
En Avant de Guingamp	French association football team
egg	food
Marvel vs. Capcom 2: New Age of Heroes	video game
Metropolis Records	Music label in the USA
County Kildare	county in Ireland
Orthodox Judaism	denomination of Judaism
anthology	collection of creative works chosen by the compiler
historical period drama	work of art set in, or reminiscent of, an earlier time period
cryptoxanthin	chemical compound
tactical role-playing game	video game genre
pirate	person practicing piracy
The Harvard Lampoon	magazine
NBA Finals	championship series of the National Basketball Association, annual from 1950; officially includes 1947 to 1949 BAA Finals; officially called the National Basketball Association World Championship Series through 1987
Zionism	movement that supports the creation of a Jewish homeland in the territory defined as the Land of Israel
boarding school	school where some or all people study and live
political thriller	thriller that is set against the backdrop of a political power struggle
Georgian architecture	set of architectural styles current between 1720 and 1840
Renaissance	cultural movement that spanned the period roughly from the 14th to the 17th century
cooking show	television genre
object-oriented programming	programming paradigm based on the concept of objects
House of Hohenzollern	dynasty of former princes, electors, kings, and emperors of Hohenzollern, Brandenburg, Prussia, the German Empire, and Romania
Uwe Boll	German film director, producer and screenwriter
broccoli	edible green plant in the cabbage family
contemporary philosophy	No description defined
1982 Cannes Film Festival	No description defined
2001 Major League Baseball season	No description defined
curator	content specialist charged with an institution's collections and involved with the interpretation of heritage material
Kristine Sutherland	actress
Rot-Weiss Essen	association football club in Germany
Prescription drug	licensed medicine that is regulated by legislation to require a medical prescription before it can be obtained
Tokyo	capital of Japan with 13 million inhabitants, and one of 47 prefectures of Japan
GNU General Public License	Set of free software licenses (GPLv1, GPLv2, GPLv3)
chicken	domesticated fowl, primarily a source of food
Lahore	capital city of the Pakistani province of Punjab
mangaka	people who create manga
Mangalore	city in Karnataka, India
macOS	operating system for Apple computers, launched in 2001 as Mac OS X
Pulitzer Prize for History	No description defined
bakery	establishment that produces and sells flour-based food baked in an oven
suspense	feeling of uncertainty and anxiety about the outcome of certain actions
prison	place in which people legally are physically confined and usually deprived of a range of personal freedoms
Kagoshima	city of Japan, capital of Kagoshima Prefecture
Lisp	programming language
Chittagong	second largest city of Bangladesh, situated at the southwestern part of the country
procedural programming	programming paradigm
coming of age	Young person's transition from childhood to adulthood
alternate history	genre of speculative fiction
Expressionism	modernist art movement
Beaux-Arts architecture	expresses the academic neoclassical architectural style
S.C. Olhanense	sports club in Portugal
number theory	branch of pure mathematics devoted primarily to the study of the integers
Pro Football Hall of Fame	No description defined
blaxploitation	film genre
Waitakere United	association football club
erotica	artistic work that deals substantively with erotically stimulating or sexually arousing subject matter
Japanese yen	official currency of Japan
Scott Lobdell	American comic writer
animated series	TV genre; set of regularly presented animated television programs
Jharkhand	Indian state
Ontario New Democratic Party	political party
Windows 7	version of the Microsoft Windows operating system
portrait	artistic representation of one or more persons
2000 Cannes Film Festival	No description defined
Soviet Air Forces	aerial warfare branch of the Soviet Union's armed forces
(+/-)-pantothenic acid	chemical compound
phytosterol	No description defined
Armenian Apostolic Church	national church
superhero	type of stock character possessing "supernatural or superhuman powers" and dedicated to protecting the public
promoter	individual or company that promotes live entertainment events
myristic acid	chemical compound
software engineer	practitioner of software engineering
association football manager	team manager in association football (soccer)
Supreme Court of Canada	highest court of Canada
Dublin	capital city of Ireland
Quebec Liberal Party	provincial political party in Quebec, Canada
farce	comedy genre
pizza	Italian dish of oven-baked bread with various toppings
Kosi Zone	one of the fourteen zones of Nepal.
music video game	music-themed video game genre
Constantinople	capital city of the Eastern Roman or Byzantine Empire, the Latin and the Ottoman Empire
Tokugawa clan	noble family
Agra	city in Uttar Pradesh, India
national university	University managed by a country
non-fiction	genre of works in contrast to fictional ones
Catholic school	parochial educational institution operated by a Catholic organization
blood plasma	liquid component of blood
imperative programming	programming paradigm that uses statements to specify state changes
vegetarian cuisine	food not including meat and animal tissue products
property developer	multifaceted business encompassing activities related to buildings and land
medical research	research
American Kennel Club	umbrella organization
literary criticism	study, evaluation, and interpretation of literature
PFC Spartak Nalchik	association football club in Russia
Gateshead F.C.	English football club
Kyushu	third largest island of Japan
legal drama	subgenre of dramatic fiction
postmodernism	art movement
hospitality	relationship between the guest and the host, or the act or practice of being hospitable
Mashhad	holy city in Islam and second largest city in Iran
PlayStation 2	Sixth-generation and second home video game console developed by Sony Interactive Entertainment
Apache Software Foundation	software foundation
Waffen-SS	armed wing of the Nazi Party's Schutzstaffel
children's television series	television programs designed for, and marketed to children
British Empire	dominions of the United Kingdom
1988 Major League Baseball season	No description defined
first-person shooter	video game genre centered around gun and other weapon-based combat in a first-person perspective;
nonviolence	philosophy, personnal or collective attitude, refusing to legitimate violence and promoting the respect of others in conflicts
costume drama	film genre
Skidmore, Owings and Merrill	American architectural and engineering firm
2012 Sundance Film Festival	2012 film festival edition
fantasy	genre of fiction
Toronto District School Board	public school system of Toronto, Ontario
Joseon	Korean kingdom, 1392 to 1897
retail	sale of goods and services from individuals or businesses to the end-user
United National Party	Political party in Sri Lanka
Neath	town and community in county borough of Neath Port Talbot, Wales
Endemol	creator, producer and distributor of multiplatform entertainment content
college	educational institution
blood	specialized bodily fluid in animals
Reform Party of Canada	No description defined
Qing dynasty	last imperial dynasty of China
renewable energy	category of energy sources
chief of police	law enforcement occupation
Ibaraki Prefecture	prefecture of Japan
Chandigarh	capital of Punjab and Haryana states, Union Territory of India
slice of life	depiction of everyday experience in art and entertainment
Order of the Three Stars	award
al-Qaeda	global militant organization
AZ Alkmaar	Dutch association football club
Le Monde's 100 Books of the Century	Wikimedia list article
This TV	American television station
September	ninth month in the Julian and Gregorian calendars
far-right	political alignment
card game	game using playing cards as the primary device
Rajasthan	Indian state
Liberal Democrats	political party in the United Kingdom
soap opera	episodic work of dramatic fiction
independent school	fee paying school in the United Kingdom
Yorkshire Terrier	dog breed
University of Tartu	university in the city of Tartu, Estonia
news program	regularly scheduled radio or television program
Hyderabad	capital of Telangana, India
Varna	city in Bulgaria
LGBT social movements	social movements that advocate for the equalized acceptance of LGBT people in society
Berlin International Film Festival	annual film festival held in Berlin, Germany
FC Luzern	association football club in Switzerland
novel	narrative text, normally of a substantial length and in the form of prose describing a fictional and sequential story
Steel Azin F.C.	association football club in Iran
mine	place for the extraction of minerals
Royal Naval Air Service	former air arm of the Royal Navy
Hiroshima Prefecture	prefecture of Japan
Nintendo Entertainment Analysis & Development	division of Nintendo
Philippine cuisine	culinary traditions of the Philippines
Bergen	city in Hordaland, Norway
Bhopal	capital of Madhya Pradesh, India
Christmas	Christian annual commemoration of the New Testament stories about the birth of Jesus Christ
apple	fruit of the apple tree
Silver Screen Partners	No description defined
Labrador Retriever	dog breed
serum	cell free fraction of blood
Caravaggio	Italian painter
Oaxaca	state of Mexico
kung fu film	film genre
prophet	person claiming to speak for divine beings
political cinema	film genre
James Cayne	American executive, salesman, and bridge player
humour	tendency of particular cognitive experiences to provoke laughter and provide amusement
Pune	city in Maharashtra, India
Persea americana	species of plant
United Malays National Organisation	No description defined
Makati	city of the Philippines in Metro Manila
ash	waste product of fire; the end product of incomplete combustion; the solid remains of fires; specifically, it refers to all non-aqueous, non-gaseous residues that remain after something is burned
Star Plus	Indian television channel
John Fritz Medal	No description defined
Democratic Unionist Party	political unionist party of Northern Ireland
Saba Qom F.C.	association football club
private equity	No description defined
director's cut	edited version of a film, TV episode, music video, etc. that is supposed to represent the director's own approved edit
Lima	capital of Peru
Bob Hamman	American bridge player and prize promoter
Communist Party of the Soviet Union	political party founded in 1912
October	tenth month in the Julian and Gregorian calendars
Tour de France	multiple-stage bicycle race primarily held in France
Shizuoka Prefecture	prefecture of Japan
2010 Sundance Film Festival	2010 film festival edition
Sandefjord Fotball	association football club
Peshawar	city in Pakistan, capital of Khyber Pakhtunkhwa
sport	forms of competitive activity, usually physical
AACTA Award for Best Adapted Screenplay	No description defined
Lasker-DeBakey Clinical Medical Research Award	No description defined
copper	chemical element with the atomic number of 29
Tartu	city in Estonia
Pechos frios	sports club in mongolia
liberal arts college	college with an emphasis on undergraduate study in the liberal arts and sciences
Kayserispor	association football club
Livingston F.C.	association football club
Nationalist Party of Australia	Former Australian political party
Royal Society	English learned society for science
horse racing	equestrian sport
Dalian Shide F.C.	Chinese football club
vegetarianism	practice of abstaining from the consumption of meat
differential topology	No description defined
61st Berlin International Film Festival	2011 film festival edition
Eastern European Time	zone time
Venice Film Festival	annual film festival held in Venice, Italy
talk show	type of television or radio show centered around conversation
picture book	book with images at least as important as words, commonly directed at children and featuring a story
County Sligo	county in Ireland
tactical shooter	video game genre
Airports Authority of India	agency that runs airports in India
humor magazine	No description defined
food	any substance consumed to provide nutritional support for the body; form of energy stored in chemical form
Nagpur	city in Maharashtra, India
capric acid	chemical compound
Grand Teton National Park	United States National Park in northwestern Wyoming
DL-fructose	chemical compound
art gallery	place (commercial) where (contemporary) art is shown for exhibition and for sale
nebula	interstellar cloud of dust, hydrogen, helium and other ionized gases
European Film Award for Best Composer	award
Islamism	set of ideologies holding that "Islam should guide social and political as well as personal life"
Bronxville	village in Westchester County, New York, USA
goat	domesticated mammal raised primarily for its milk
January	first month in the Julian and Gregorian calendars
Ontario Liberal Party	political party in Ontario, Canada
CinemaScope	No description defined
Srinagar	city in Jammu and Kashmir, India
Bharatiya Janata Party	major political party in India
Sialkot	human settlement
Silkeborg IF	association football club in Denmark
massively multiplayer online role-playing game	video game genre
Vertigo	imprint of comic-book publisher DC Comics
criminality	collective term for offenses as a overall phenomenon
independent politician	individual not affiliated to any political party
A.C. Monza Brianza 1912	association football club
Indian National Congress	major political party in India
Guitar Hero II	2006 video game
spy film	film genre
Thiruvananthapuram	South Indian city, capital of Kerala state
Windows XP	version of the Microsoft Windows operating system
Coimbatore district	district of Tamil Nadu, India
Progressive Conservative Party of Canada	former Canadian political party
teen film	film genre, the films usually involve adolesent characters and/or made for viewers of the same age
County Kerry	county in Ireland
Labour Party	political party in Ireland
anti-fascism	opposition to fascist ideologies, groups and individuals
L-Aspartic Acid	chemical compound
JavaScript	programming language
32nd Berlin International Film Festival	1982 film festival edition
GNU/Linux	operating system based on GNU and the Linux kernel
civil and political rights	rights preventing the infringement of personal freedom by other social actors
protein	biological molecule consisting of chains of amino acid residues
ice cream	frozen dessert
Bursaspor	association football club in Turkey
German Shepherd dog	dog breed
skateboarding	action sport on skateboards
Padma Vibhushan	second highest civilian award of the Republic of India; preceded by Bharat Ratna and followed by Padma Bhushan
C++	general purpose high-level programming language
Glasnevin Cemetery	cemetery in Glasnevin, Dublin, Ireland; largest non-denominational cemetery in the country
blockbuster	term for a popular film
Order of the Star of Romania	order
coconut milk	liquid that comes from the grated meat of a coconut
Pangasinan	province of the Philippines
pharmaceutical industry	develops, produces, and markets drugs or pharmaceuticals licensed for use as medications
conservatory	educational institution specialized in the study, training and research of music
Patna	capital city of Bihar, India
bisexuality	sexual and/or romantic attraction to people of both the opposite sex or gender and the same sex or gender
anti-racism	beliefs, actions, movements, and policies adopted or developed to oppose racism
John Broome	comic book writer
Jeff Meckstroth	American bridge player
air travel	form of travel in flight vehicles
Kerala	Indian state
miniseries	television show production which tells a single story in a limited number of episodes
Pre-Code Hollywood	US cinema before the Motion Picture Production Code introduction
Basra	capital of Basra Governorate, in southern Iraq
knight	person granted an honorary title by a monarch or other political leader
learned society	organization that exists to promote an academic discipline or profession
cis-oleic acid	chemical compound
genus	taxonomic rank (or a taxon in that rank)
Sapporo	city on Hokkaido, Japan
glucose	group of chemical compounds
freedom of speech	political right to communicate one's opinions and ideas
A Great Day in Harlem	photograph by Art Kane
farmer	person that undertakes agriculture
monster film	film genre
PlayStation 3	Seventh-generation and third home video game console developed by Sony Interactive Entertainment
turn-based tactics	No description defined
Band Hero	video game
Dehradun	capital of Uttarakhand, India
Bhubaneswar	capital of the Indian state of Odisha
consumer electronics	collective term for electrical appliances that serve the end user's needs
Romanticism	period of artistic, literary, and intellectual movement that started in 18th century Europe
National Baseball Hall of Fame and Museum	No description defined
young adult	stage of human development
DL-lysine	mixture of stereoisomers
Ottoman Dynasty	dynasty
sheriff	law enforcement official
memoir	type of autobiographical or biographical writing
veganism	practice of abstaining from the use of animal products
World Golf Hall of Fame	No description defined
Communist Party USA	American political party
philanthropy	effort or inclination to increase the well-being of humankind, as by charitable aid or donations
Haryana	Indian state
streaming media	continuous multimedia operated and presented to users by a provider
Central European Time	standard time (UTC+01:00)
Colm Meaney	Irish actor
Port-au-Prince	capital of Haiti
buddy film	film genre in which two people of the same sex (historically men) are paired
Indian Army	land based branch of the Indian Armed Forces
black comedy	comic work that employs black humor or gallows humor
rail transport	conveyance of passengers and goods by way of wheeled vehicles running on rail tracks
parody	imitative work created to mock, comment on or trivialise an original work
National Women's Hall of Fame	No description defined
Betaine	No description defined
Kagoshima Prefecture	prefecture of Japan
national park	park used for conservation purposes of animal life and plants
role-playing video game	video game genre
surgeon	physician with surgical specialty
Fine Gael	a liberal-conservative and Christian democratic political party in Ireland
Communist Party of China	political party of the People's Republic of China
Afro-Asiatic languages	language family
graph theory	study of graphs, which are mathematical structures used to model pairwise relations between objects
Racing de Santander	Spanish football club
immortality	the ability to live forever, or eternal life
cryptography	practice and study of techniques for secure communication in the presence of third parties
family	taxonomic rank or a taxon at that rank
selenium	chemical element with atomic number of 34
Farnborough F.C.	football club
Northern Dancer	Canadian-bred Thoroughbred racehorse
Mysore	city in the state of Karnataka, India.
Tamil Nadu	Indian state
Apache License	any of a set of free software licenses developed by the organization
Panserraikos F.C.	association football club in Greece
communication medium	storage and delivering agent of information or data
FSV Frankfurt	German association football club
military branch	subdivision of the national armed forces of a sovereign nation or state
2009 Tour de France	No description defined
bus	large vehicle for transporting people
third-person shooter	type of action video game where player can see the avatar on-screen in a third-person view
iOS	mobile operating system by Apple
Royal Victorian Chain	No description defined
Order of the Garter	order of chivalry in England
L-Serine	chemical compound
Guatemala City	capital and largest city of the Republic of Guatemala
Turing Award	Computer science award
FC Dnipro Dnipropetrovsk	professional football club based in Dnipropetrovsk, Ukraine
Bihar	Indian state
Scottish National Party	Scottish political party
PFC Beroe Stara Zagora	association football club in Bulgaria
St Patrick's Athletic F.C.	association football club
Honshu	largest island of Japan
Uttar Pradesh	Indian state
Populous	architectural firm
Kabul	capital of Afghanistan
Golden Retriever	dog breed
Democratic Party	political party in the United States
SV Eintracht Trier 05	association football club
Bangalore	Indian city
Baroque	cultural movement, starting around 1600
National Gallery	art gallery in London housing the British national collection of pre-20th century Western paintings
Android	Linux-based mobile operating system
Greek mythology	body of myths and teachings of the ancient Greeks
International development	wide concept concerning the level of development on an international scale
Chiapas	state of Mexico
March	third month in the Julian and Gregorian calendars
Gettysburg	1993 film by Ronald F. Maxwell
Ross County F.C.	Scottish professional association football club based in Ross-shire
pain	type of unpleasant feeling
Life Insurance Corporation of India	Indian state-owned insurance group and investment company
Impressionism	19th-century art movement
House of Bourbon hoy	European royal house of French origin
train	one or more self-propelled vehicles that move along fixed rails to transport passengers or cargo
Whig Party	political party in the USA in the 19th century
proprietary software	computer software released under a license restricting use, study or redistribution
County Wexford	county in Ireland
James E. Sullivan Award	award presented by the American Amateur Athletic Union
hotel	establishment that provides lodging paid on a short-term basis
world cinema	film genre
Naismith Memorial Basketball Hall of Fame	award
House of Orange-Nassau	branch of the European House of Nassau
heterosexuality	romantic and/or sexual attraction or behavior between people of opposite genders
stand-up comedy	comedy style where the performer addresses the audience directly
County Tipperary	county in Ireland
San Salvador	capital of El Salvador
absurdism	the conflict between the human tendency to seek inherent value and meaning in life and the human inability to find any; does not mean "logically impossible", but rather "humanly impossible"; a philosophical school of thought stating
PFC Litex Lovech	association football club in Bulgaria
broadcasting	distribution of audio and video content to a dispersed audience via any audio or visual mass communications medium
Solaris	No sirvio hasta ser lanzadodeveloped by Sun Microsystems
real-time strategy	strategy video game subgenre
Social Democratic Party	political party in the United Kingdom
cattle	domesticated form of Aurochs, originally described as species Bos taurus
mustangos	type of horse
National Gallery of Art	national art museum in Washington, D.C.
58th Berlin International Film Festival	2008 film festival edition
Whoniverse	setting of TV series Doctor Who and related creative works
Veracruz	state of Mexico
phosphorus	chemical element with the atomic number of 15
May	fifth month in the Julian and Gregorian calendars
ninja	type of covert agent or mercenary in feudal Japan
Gifu Prefecture	prefecture of Japan
ethanol	chemical compound
Alaska Time Zone	time zone observing UTC -9 during standard time and UTC -8 during daylight saving time
County Donegal	county in Ireland
melodrama	dramatic work that exaggerates plot and characters in order to appeal to the emotions
Morecambe F.C.	English football club
biography	account of a person's life written by another person
County Kilkenny	county in Ireland
Wexford	county town of Co. Wexford, Ireland
beef	meat from cattle
racemethionine	chemical compound
Perkin Medal	award
drama film	film genre
Georgetown	capital city of Guyana
Sparta Rotterdam	Dutch association football club
land-grant institution	institution of higher education in the United States designated by a state to receive the benefits of the Morrill Acts of 1862 and 1890
FC Schaffhausen	association football club
Assam	Indian state
Democratic-Republican Party	historical American political party
Rawalpindi	city in the Punjab Province, Pakistan
2010 Toronto International Film Festival	2010 film festival edition
Society of Jesus	christian male religious congregation of the Roman Catholic Church
functional programming	programming paradigm
Voyages Extraordinaires	No description defined
Scottish Labour Party	part of the United Kingdom Labour Party that operates in Scotland
County Limerick	county in Ireland
horse	domesticated (work) animal
true crime	literary genre
Television Broadcasts Limited	television station in Hong Kong
time in China	No description defined
properties of water	physical and chemical properties of pure water
anthology series	radio or television series that presents a different story and a different set of characters in each episode
VHS	consumer-level analog recording videotape-based cassette standard
Weymouth F.C.	association football club
restaurant	single establishment which prepares and serves food, use Q18534542 for restaurant chains
linoleic acid	chemical compound
Touch and Go Records	American record label
television comedy	television genre
alpha-tocopherol	pharmaceutical drug
Order of the Thistle	order of chivalry associated with Scotland
Napalm Records	record label
Polyunsaturated fatty acid	No description defined
United States Coast Guard	branch of the United States Armed Forces
Rapid City	county seat of Pennington County, South Dakota, United States
lacrosse	team sport
Mystery	Wikipedia disambiguation page
community college	type of educational institution
Dietary fiber	indigestible portion of food derived from plants
cult film	film that has acquired a cult following
screwball comedy film	principally American genre of comedy film
Monte Carlo	administrative area of the Principality of Monaco
zinc	chemical element with the atomic number of 30
35 mm film	film gauge
House of Stuart	European royal house
Whodunit	No description defined
Chelmsford City F.C.	No description defined
Steve Englehart	American writer
Bureau of Land Management	agency within the United States Department of the Interior
IMAX	large-screen film format
Liberal National Party of Queensland	political party in Queensland, Australia
Chiyoda	special ward of Tokyo
priest	person authorized to lead the sacred rituals of a religion
Unix-like	operating system that behaves in a manner similar to a Unix system
mixed-sex education	Mixed-sex education
Kickers Offenbach	German association football club
church	religious building for Christian worship
United States House Committee on Energy and Commerce	No description defined
light gun shooter	video game genre
Red Army	1917-1946 ground warfare branch of the Soviet Union's military
FC Energie Cottbus	association football club in Germany
pasta	type of noodle, staple food of traditional Italian cuisine
political satire	part of satire that specializes in gaining entertainment from politics
Larissa F.C.	association football club in Greece
Punjab State	state of India
Asteras Tripoli F.C.	association football club in Greece
Western Australian Legislative Assembly	legislature of the State of Western Australia
Stalybridge Celtic F.C.	No description defined
Lucknow	capital of Uttar Pradesh, India
television special	type of television program
conservatism	political philosophy focused on retaining traditional social institutions
Mars	fourth planet from the Sun
independent record label	type of record label
Delhi	Indian metropolis that includes New Delhi
Limerick	city in Ireland in the province of Munster
34th Berlin International Film Festival	1984 film festival edition
topology	subfield of mathematics
New Delhi	district of Delhi and Indian capital city
French cuisine	cuisine originating from France
Parramatta Eels	rugby league football club
Cork	city in Ireland
House of Bernadotte	royal house of Sweden
County Cork	county in Ireland
anti-communism	opposition to communism
Order of St. Olav	chivalric order
independent film	film production mostly or completely done outside of the major film studio system
structural engineer	person who analyzes, designs, plans, and researches structural components and structural systems
car bomb	improvised explosive device
L-Arginine	chemical compound
SV Ried	association football club in Austria
documentary film	nonfictional motion picture
Marrakesh	city in Morocco
Solar System	planetary system of the Sun
Helsingborgs IF	sports club in Helsingborg, Sweden
Queen of the South F.C.	association football club
cheese	generic term for a diverse group of milk-based food products
Order of the British Empire	order of chivalry of British constitutional monarchy
Republican Party	political party in the United States
Super 35	No description defined
pear	fruit
Super Smash Bros. Brawl	video game
lesbian	term describing sexual attraction between females
romantic fantasy	phantasy subgenre
House of Savoy	noble family
Dalian Aerbin F.C.	association football club
Conservative Party of Canada	political party in Canada founded in 2003
life simulation game	subgenre of simulation video games
(E)-phytonadione	chemical compound
fairy tale	fictional story featuring folkloric fantasy characters
programmer	person who writes computer software
medical novel	literary genre
Cannes Film Festival	annual film festival held in Cannes, France
action film	film genre
Minato-ku	special ward of Tokyo
beat 'em up	video game genre
Spinefarm Records	record label
S.K. Sturm Graz	association football club in Austria
steampunk	genre
County Waterford	county in Ireland
propaganda film	film genre
Guitar Hero III: Legends of Rock	video game
November	eleventh month in the Julian and Gregorian calendars
jockey	someone who rides horses in horse racing or steeplechase racing
sucrose	chemical compound
Pulitzer Prize for Music	No description defined
horror literature	literary genre
national historic landmark of the USA	recognized national site in the USA
Tom DeFalco	American comics writer and editor
Pakistan Peoples Party	centre-left, progressive, and social democratic political party in Pakistan
cathedral	Christian church, which is seat of a bishop
renaissance architecture	architectural style
Edison Medal	award
Python	general-purpose, high-level programming language
Prayag	Indian city
Punjab	province of Pakistan
news magazine	typed, printed, and published piece of paper, magazine or a radio or television program
concert film	video of a performance in concert
reality television	genre of television programming that documents unscripted situations and actual occurrences
wuxia	Chinese cinematographic genre
action	fiction-writing mode or genre
2008 Sundance Film Festival	2008 film festival edition
2008 Tour de France	No description defined
Frank Skinner	American composer
Servette FC	association football club in Switzerland
1994 Major League Baseball season	No description defined
ECW Hardcore TV	television series
animal rights	concept of inalienable rights for non-human animals
Greenock Morton F.C.	association football club
consultation	structured interview or similar form of communication that will solve a problem or an issue
contemporary art	art of the present time
Panama City	capital of Panama
Christian Democratic Union	political party in Germany
largemouth bass	species of fish
subspecies	taxonomic rank subordinate to species
Social Democratic Party of Germany	political party in Germany
House of Windsor	royal house of the United Kingdom and the other Commonwealth realms
Guitar Hero World Tour	video game
sexploitation film	genre of low-budget films
House of Saxe-Coburg and Gotha	German dynasty
Dark Horse Comics	American comic book and manga publisher
supernatural	term meaning "that which is not subject to the laws of physics"
Progressive Conservative Party of Ontario	political party in Ontario, Canada
police procedural	subgenre of detective fiction
apocalyptic fiction	genre of speculative fiction describing the end of human civilization
movement moderne	No description defined
pope	bishop of Rome, leader of the worldwide Catholic Church, and head of state of the Vatican City
Ismaily SC	association football club
palmitoleic acid	chemical compound
choreography	the art of arranging movements, such as in dance
cabbage	variety of plants
PHP	programming language
Royal Victorian Order	series of awards in an order of chivalry of the United Kingdom
werewolf	mythological human with the ability to shapeshift into a wolf or an anthropomorphic wolf-like creature
Saint Denis Basilica	basilica located in Seine-Saint-Denis, in France
adventure film	film genre
Liberal Party of the Philippines	liberal party in the Philippines
Arunachal Pradesh	Indian state
Allium cepa	species of plant (for the onion, use Q21558811)
animal	kingdom of multicellular eukaryotic organisms
vitamin B6	No description defined
Ahmedabad	city in the state of Gujarat, India
animated film	film for the cinema, television or computer screen that is made by using drawings, stop motion or computer animation
Buffyverse	fictional universe for Buffy the Vampire Slayer and Angel
abugida	writing system
List of natural satellites	Wikimedia list article
film adaptation	films based on other media (books, plays, etc.)
House of Oldenburg	dynasty
Cebu City	city of the Philippines and capital of the province of Cebu
National Museum of Racing and Hall of Fame	No description defined
glycine	chemical compound
Java	object-oriented programming language
space opera	subgenre of science fiction that emphasizes romantic, often melodramatic adventure
Bath City F.C.	association football club in England
sword and sorcery	genre of fantasy fiction
primary school	school in which children receive primary or elementary education from the age of about five to twelve
postmodern architecture	architectural style
Farsley Celtic A.F.C.	No description defined
Yokohama	city in Kanagawa prefecture, Japan
Associazione Sportiva Livorno Calcio	Italian association football club
interactive television	form of media convergence
Metropolitan Museum of Art	art museum in New York, New York
University College Cork	university college
Labour Party	political party in the United Kingdom
Miami metropolitan area	most populous metropolitan area in the U.S. state of Florida
C	general-purpose programming language
Niigata Prefecture	prefecture of Japan
Toronto International Film Festival	annual film festival held in Toronto, Ontario, Canada
Revelation Records	independent record label focusing on hardcore punk
1956 Major League Baseball season	No description defined
The Troubles	ethno-political conflict in Northern Ireland
short film	any film not long enough to be considered a feature film
Chiba Prefecture	prefecture of Japan
Europop	pop music genre
Chhattisgarh	Indian state
dystopia	undesirable state of society
Uttarakhand	Indian state
Arbroath F.C.	association football club
Kanpur	industrial city in Uttar Pradesh, India
choline	chemical compound
business school	university-level institution granting degrees in business administration
mountaineering	sport of mountain climbing
Waseda University	university in Japan
Fukushima Prefecture	prefecture of Japan
Yarrow Shipbuilders	former shipbuilding firm based in Glasgow, Scotland
Jammu and Kashmir	Indian state
Indore	city in Madhya Pradesh, India
carrot	root vegetable, usually orange in color
arachidonic acid	chemical compound
for-profit education	education from a profit-making business
Philippine Standard Time	time zone
musical film	film genre
Playboy Playmate	female model featured in a centerfold of  Playboy' magazine
tragicomedy	No description defined
species	one of the basic units of biological classification and a taxonomic rank
automobile magazine	No description defined
Vigor Shipyards	company
over-the-counter drug	medicines sold directly to a consumer without a prescription from a healthcare professional, as opposed to prescription drugs, which may only be sold to consumers possessing a valid prescription
Libertarian Party	national political party in United States
Royal Australian Air Force	air warfare branch of Australia's armed forces
Munhwa Broadcasting Corporation	South Korean broadcasting channel
Royal Australian Navy	naval warfare branch of the Australian Defence Force
trade union	organization of workers with common goals
comedy film	genre of film in which the main emphasis is on humour
62nd Berlin International Film Festival	2012 film festival edition
Southern Lord Records	No description defined
anti-war movement	No description defined
Waterford	city in the Republic of Ireland
historical fiction	story that is set in the past; film and literary genre
Star Alliance	global airline alliance
L-Isoleucine	chemical compound
August	eighth month in the Julian and Gregorian calendars
Ulster Unionist Party	political party in Northern Ireland
Contemporary hit radio	No description defined
Darjeeling	town in the Indian state of West Bengal
Tooth & Nail Records	No description defined
monster	creature that is often hideous and may produce fear or physical harm
No label defined	No description defined
Unix	computer operating system
Indianapolis 500	auto race held in Speedway, Indiana, United States
lipid	naturally occurring molecules including fats, waxes, sterols, fat-soluble vitamins and others
astrologer	person who practices astrology
war film	film genre depicting wars
investment bank	type of private company
Imperial House of Japan	members of the extended family of the reigning Emperor of Japan
Poaceae	family of plants
dog	domestic animal
New Zealand Labour Party	major New Zealand political party
New Zealand National Party	major New Zealand political party
research	formal work undertaken systematically to increase the stock of knowledge
60th Berlin International Film Festival	2010 film festival edition
Chennai	south Indian city, capital of the state of Tamil Nadu
Kettering	town in Northamptonshire, England
Merge Records	independent record label
young adult literature	literature written for adolescents and young adults
medical drama	television drama program where events center around a medical environment
Gross out	No description defined
Mac OS	operating systems produced since 1984 by Apple to Macintosh
turn-based strategy	genre of strategy games where players take turns when playing
Amritsar	city in north-western part in India
PFC Botev Plovdiv	association football club
sex comedy	genre in which comedy is motivated by sexual situations and love affairs
state school	type of school funded in whole or in part by taxation
Western	genre of films set primarily in the 19th century American West
Liberal Party of Canada	oldest federal political party in Canada
platform game	video game genre
sheep	domesticated animal
sustainability	property of biological systems to remain diverse and productive indefinitely
Hezbollah	Shi'a Islamist militant group and political party based in Lebanon
Miss Universe	annual international beauty contest
French Revolution	social and political revolution occurring from 1789 to 1798
Manila	capital city of the Philippines
Odisha	state of India
SCE Studio Liverpool	former video game development house
bulldog	dog breed
road movie	film genre
calcium	element with the atomic number of 20
Streamline Moderne	late type of the Art Deco architecture and design
Jalandhar	city in India
political drama	play, film or TV program that has a political component
Cessna	aircraft manufacturing subsidiary of Textron
Taliban	Islamic fundamentalist political movement in Afghanistan
Australian Greens	Australian political party
Windows Vista	version of the Microsoft Windows operating system
comedy of manners	theatrical genre
art dealer	person that buys and sells works of art
airline	company that provides air transport services for traveling passengers and freight
All-rounder	Cricket format
entertainment	activity that holds the attention and interest of an audience, or gives pleasure and delight
bay	hair coat color of horses
Nagasaki	capital Nagasaki Prefecture on the island of Kyushu in Japan
neo-noir	film genre; modern form of film noir
conceptual art	art movement
Grays Harbor County	county in the U.S. state of Washington
nature	phenomena of the physical world, and also to life in general
2009 Sundance Film Festival	2009 film festival edition
dragon	legendary creature
L-Tryptophan	chemical compound
59th Berlin International Film Festival	2009 film festival edition
BSC Young Boys	sports club in Switzerland
newspaper	scheduled publication containing news of events, articles, features, editorials, and advertising
F.K. Vojvodina	association football club in Serbia
carbohydrate	organic compound that consists only of carbon, hydrogen, and oxygen
operating system	collection of software that manages computer hardware resources
Florida Department of Environmental Protection	No description defined
Clallam County	county in the U.S. state of Washington
software	non-tangible executable component of a computer
semiconductor	material that has electrical conductivity intermediate to that of a conductor and an insulator
Carry On	sequence of 31 low-budget British comedy motion pictures
Quezon City	city of the Philippines in Metro Manila
Nagano Prefecture	one of 47 prefectures of Japan
slapstick	genre
Miyagi Prefecture	prefecture of Japan
saturated fat	type of fat
Saint Patrick	5th-century Romano-British Christian missionary and bishop in Ireland
Dhaka	capital of Bangladesh
Havok	physics engine developed by Irish company Havok
Kanagawa Prefecture	prefecture of Japan
Kozhikode	city in Kerala
niacin	chemical compound
black-and-white	monochrome form in visual arts
African National Congress	political party in South Africa
Jaipur	capital of Rajasthan, India
romantic comedy	film genre
merchant	businessperson who trades in commodities that were produced by others
FC Krylia Sovetov Samara	association football club in Russia
science fiction	genre of fiction
Goa	state on the western coast of India
folklore	consists of legends, music, oral history, proverbs, jokes, popular beliefs, fairy tales, etc.
Revisionist Western	film genre
private university	university not operated by a government
thriller	genre of literature, film, and television programming
high school	institution which provides all or part of secondary education
sketch comedy	series of short comedy scenes or vignettes
manganese	chemical element with the atomic number of 25
communism	socialist political movement and ideology
Shiraz	city in Fars Province, Iran
American Academy of Arts and Letters	honor society
military history	humanities discipline
Order of Saint Michael and Saint George	series of appointments of an order of chivalry of the United Kingdom
public limited company	type of public company in the UK, some Commonwealth jurisdictions, and Ireland
video game industry	economic sector involved with the development, marketing and sales of video games
Alliance '90/The Greens	political party in Germany
disaster film	film genre
Microsoft Windows	family of operating systems produced for personal computers, servers, smartphones and embedded devices
Newfoundland Time Zone	zone time
Keio University	university in Kanagawa Prefecture, Japan
private school	school type not administered by local, state or national governments
Nazism	ideology and practice associated with the 20th-century German Nazi Party and state
Multivariable calculus	calculus of functions of several independent variables
cat	domesticated species of feline
stearic acid	chemical compound
superhero film	film genre
Rock Band 2	2008 video game
Cumann na nGaedheal	former irish political party
German cuisine	national cuisine of Germany
Okinawa Prefecture	prefecture of Japan
video	electronic medium for the recording, copying and broadcasting of moving visual images
autobiography	account of the life of a person, written by that person
Student rights	No description defined
Hamas	Palestinian Sunni-Islamic fundamentalist organization, with an associated military wing
Willem II	association football club in the Netherlands
Karachi	city in Pakistan and capital of the Sindh province
beauty contest	competition of beautiful people
Norwegian Labour Party	Norwegian political party
County Wicklow	county in Ireland
Balochistan	republic in Asia
magnet school	public schools with specialized courses or curricula
researcher	professional who engages in research
Accra Hearts of Oak SC	The oldest local football team in Ghana
Southern soul	Soul Genre
Sundance Film Festival	annual film festival held in Park City, Utah, USA
African popular music	No description defined
independent music	collective term for artists who wish to act independently
planet	celestial body orbiting a star or stellar remnant
libertarianism	set of political philosophies that uphold liberty as the highest political end
sumo	full-contact wrestling sport
Antarctica	polar continent on the Earth's southern hemisphere
university-preparatory school	secondary school that prepares students for college or university
slasher film	subgenre of horror film
Communist Party of India (Marxist)	political party
Chakri Dynasty	dynasty
County Monaghan	county in Ireland
Victory Records	record label
A.S. Nancy-Lorraine	French association football club
pork	meat from a pig
film festival	event with films being shown
game show	type of television or radio program where contestants compete for prizes
wydad casablanca	sports club in Casablanca, Morocco
Mumbai	capital and district of Maharashtra, India
Coimbatore	city located in Tamil Nadu, India
Maharashtra	Indian state
Fawn	No description defined
Galway	city in Ireland
chicken	meat of a chicken
broadsheet	largest newspaper format
Australian Army	land warfare branch of Australia's defence forces
Venus	telluric planet, second closest from the Sun
Fukuoka Prefecture	prefecture of Japan
gluten-free diet	diet that excludes gluten
Saitama Prefecture	prefecture of Japan
County Galway	county in Ireland
psychological thriller	specific sub-genre of the broad ranged thriller
County Roscommon	county in Ireland
general contractor	profession
blonde	hair color
People's Action Party	ruling political party in Singapore
truss bridge	bridge whose load-bearing superstructure is composed of a truss
heist film	film that has an intricate plot woven around a group of people trying to steal something
comedy-drama	genre of theatre, film, and television
Pampanga	province of the Philippines
Beitar Jerusalem F.C.	association football club in Israel
2011 Toronto International Film Festival	2011 film festival edition
L-Histidine	chemical compound
palmitic acid	chemical compound
Garry Chalk	Canadian actor
County Dublin	county in Ireland
Cyril J. Mockridge	Film and television composer
East Africa Time	zone time
prison film	film genre concerned with prison life and often prison escape
Federalist Party	first American political party
Australian Labor Party	political party in Australia
cook	occupation involving cooking food
Rock and Roll Hall of Fame	museum located on the shore of Lake Erie in downtown Cleveland, Ohio, United States
FC Kryvbas Kryvyi Rih	association football club in Ukraine
fiction	any story or setting that is derived from imagination, can be conveyed through any medium (films, books, audio plays, games, etc.)
Monounsaturated fat	No description defined
Kochi	city in India
Borjigin	imperial clan of Genghis Khan and his successors
County Mayo	county in Ireland
Khyber Pakhtunkhwa	province of Pakistan
accountant	practitioner of accountancy or accounting
sodium	element with the atomic number of 11
Hiroshima	city in Japan
L-alanine	chemical compound
riboflavin	chemical compound
experimental film	film genre
Sri Lanka national cricket team	national sports team
American Philosophical Society	United States scholarly organization  that promotes knowledge in the sciences and humanities
psychic	person who claims to use extrasensory perception to identify information hidden from the normal senses
Rostov-on-Don	Russian city
LGBT	initialism referring to lesbian, gay, bisexual, and transgender individuals
Eastbourne Borough F.C.	association football club
Kilkenny	city in County Kilkenny, Ireland
green politics	political ideology that aims to create an ecologically sustainable society rooted in environmentalism, social liberalism, and grassroots democracy
Conservative Party	political party in the United Kingdom
Chrysler	car brand of Chrysler
Grays Athletic F.C.	football club in Grays, United Kingdom
SV Darmstadt 98	association football club in Germany
National Party of Australia	Australian political party
news	communication of selected information on current events
Order of the Elephant	Highest order of Denmark
L-threonine	pharmaceutical drug
crown prince	heir to the throne
Cairo	capital city of Egypt
children's literature	stories, books, and poems that are enjoyed by and targeted primarily towards children
action game	video game genre
Mr. Prospector	American thoroughbred racehorse
International Tennis Hall of Fame	sports museum in Newport, USA
British Columbia Liberal Party	political party
Blu-ray Disc	optical disc storage medium
Sovereign Military Order of Malta	Catholic hospitaller order
FreeBSD	free Unix-like operating system
limited company	company in which the liability of members or subscribers of the company is limited
motivational speaking	No description defined
County Meath	county in Ireland
DVD	optical disc
Capsicum	genus of plants
L-Valine	chemical compound
AGOVV Apeldoorn	No description defined
experimental film	cinematic works that are experimental form or content
chanson	20s. and 21s. chanson musical genre
Quetta	city in Pakistan
West Bengal	Indian state
Guitar Hero 5	video game
Manipur	Indian state
milk	white liquid produced by the mammary glands of mammals
FC Chornomorets Odesa	professional association football club based in Odessa, Ukraine
animation	process of creating animated films
petroleum	naturally occurring flammable liquid
mockumentary	film genre in which fictional events are presented in documentary style to create a parody
Alianza Lima	association football club in Peru
Scroll and Key	No description defined
professional wrestling	entertainment form that mimics contact sports
massively multiplayer online game	multiplayer video game which is capable of supporting large numbers of players simultaneously
C.F. Atlante	Mexican professional football club
day school	type of school
financial services	economic service provided by the finance industry
Royal Medal	silver-gilt medal, of which three are awarded each year by the Royal Society
Bread	staple food prepared from a dough
Liberal Party of Australia	Australian political party
educational television	use of television programs in the field of distance education
Perl	interpreted programming language
Sindh	province of Pakistan
Equal Vision Records	record label
Hans J. Salter	American composer
Solanum lycopersicum	species of plant
Gujarat	state of India
magnesium	element with the atomic number of 12
role-playing game	game in which players assume the roles of characters in a fictional setting
Madurai	City of Tamil Nadu in southern India
Cebu	province of the Philippines
Dutch Golden Age	History of the Netherlands 1575 to 1675
pop art	art movement
flood	overflow of water that submerges land
Denizlispor	sports club in Turkey
2012 Toronto International Film Festival	2012 film festival edition
women's rights	rights claimed for women and girls worldwide
Aspyr	video game publisher
BSD license	family of permissive free software licenses, imposing minimal restrictions on the redistribution of covered software
film noir	film genre
39th Berlin International Film Festival	1989 film festival edition
Carmine Infantino	Artist
Karnataka	Indian state
