Chapman University	No description defined
University of California, Irvine	public research university in Irvine, California, United States
University of the Pacific	private university in Stockton, California, United States
University of Idaho	public research university in Moscow, Idaho, USA
Columbia Business School	business school
Washtenaw County	county in Michigan, United States
Iowa Writers' Workshop	No description defined
Bloomfield Hills	city located in the heart of Metro Detroit's affluent northern suburbs in Oakland County
Washington and Lee University	No description defined
Fort Lauderdale	county seat of Broward County, Florida, United States
Volusia County	county in Florida, United States of America
Bellingham	city in, and the county seat of, Whatcom County in the State of Washington, United States
School of American Ballet	No description defined
Sunnyvale	city in Santa Clara County, California, United States
University of Maine	public research university in Orono, Maine
Columbia	planned community in Howard County, Maryland, United States
Illinois	state of the United States of America
Hollywood Forever Cemetery	cemetery in Los Angeles, California, United States
Denton County	county in Texas, USA
Kansas City	county seat of Wyandotte County, Kansas, United States
Stetson University	No description defined
Loyola Marymount University	Jesuit university in Los Angeles
Herkimer County	county in New York, United States
Smith College	private women's liberal arts college in Massachusetts
Natchez	only city and county seat of Adams County, Mississippi, United States
Aspen	town in Pitkin County, Colorado, USA
Biloxi	city in Harrison County, Mississippi
Flint	county seat of Genesee County, Michigan, United States of America
Rutgers University	multi-campus American public research university in New Jersey, United States
Merced County	county in California, USA
University of Vermont	public research university
Fargo	city in North Dakota, United States of America
Gulfport	city in Mississippi
Anne Arundel County	county in Maryland, United States
Flathead County	county in Montana, United States
Middle Tennessee State University	public university located in Murfreesboro, Tennessee, United States
Passaic County, New Jersey	county in New Jersey
Ocean County	county in New Jersey, United States
St. Lawrence University	liberal arts college in Canton, Saint Lawrence County, New York, USA
Appleton	city in and county seat of Outagamie County, Wisconsin
Stanford	census-designated place in Santa Clara County, California, United States
Jefferson County	county in New York, United States
Appalachian Mountains	mountain range in the eastern United States and Canada
Vancouver	city in Washington, United States
Charlottesville	city in Virginia, United States
Emory University	private research university in Druid Hills, Georgia, United States
North Hollywood	district in the San Fernando Valley region of the city of Los Angeles California
Lansing	city in Ingham County, Eaton County and Clinton County, Michigan, USA and Michigan federated state capital city
Pensacola	county seat of Escambia County, Florida, United States
San Mateo County	county in California, United States of America
Pennsylvania	state of the United States
Greenville	city in Washington County, Mississippi, United States
Jefferson Parish	parish in Louisiana, United States
Bellevue	city in the Eastside region of King County, Washington, United States
Lakewood	city in Ohio
Tuscola County	county in Michigan, United States
Asheville	county seat of Buncombe County, North Carolina, United States
Denton	city in Texas, USA
University of Minnesota	public research university in Minneapolis and Saint Paul, Minnesota, United States
Jefferson County	county in Colorado, United States
Scranton	county seat city in Lackawanna County, Pennsylvania, USA
Lexington	city in the US state Massachusetts
Rockland County	suburban county in New York, United States
Arizona State University	public university located in the Phoenix metropolitan area, Arizona, United States
Mississippi State University	public university in Starkville, Mississippi, USA
Penobscot County	county of Maine, United States of America
Indiana State University	public university in Terre Haute, Indiana, United States
Stearns County	county in Minnesota, USA
The Catholic University of America	university in Washington, D.C., United States
Rochester	city in Minnesota, United States of America
Cedar Rapids	city in Iowa
Highland Park	city in Lake County, Illinois, United States
McLean County	county in Illinois
Iowa City	city in Johnson County, Iowa
Houston	county seat of Harris County, Texas, United States
Manchester	city in Hillsborough County, New Hampshire, USA
Patrick O'Neal	American actor
Medford	city in Oregon
Cumberland	city in Allegany County, Maryland, United States
Dakota County	county in Minnesota, United States
Huntington	city in the U.S. state of West Virginia
California State University, Sacramento	university in Sacramento, California
Groton School	school
Sacramento County	county in California, USA
North Dakota State University	No description defined
Washington County	county in Oregon
Prince George's County	county located in the U.S. state of Maryland
South Bend	city in Indiana, United States of America
Pittsfield	city in Massachusetts
Jackson County	county in Michigan, US
Kalamazoo	county seat of Kalamazoo County, Michigan, United States
California State University, Long Beach	public university in Long Beach, California, United States
University of Maryland, College Park	public research university in the city of College Park in Prince George's County, Maryland
Boston	county seat in Suffolk County, Massachusetts, USA and Massachusetts federated state capital city
Macomb County	county in Michigan, United States
West Hartford	town in Connecticut, United States
Oswego	city in and county seat of Oswego County, New York, United States
New Hampshire's 2nd congressional district	No description defined
Idaho	state of the United States of America
Shelby County	county in Tennessee, United States of America
Brandeis University	private research university in Waltham, Massachusetts
Princeton Theological Seminary	seminary
Larimer County	county in Colorado, United States
Bucknell University	No description defined
Georgetown University Law Center	law school of Georgetown University
Morristown	town in Morris County, New Jersey, USA
Daytona Beach	city in Florida, United States
Anchorage	city in Alaska, USA
Florida A&M University	public, historically black university in Tallahassee, Florida (U.S.)
Cascade Range	mountain range in western North America
Livingston County	county in New York
University of Rochester	private, nonsectarian, research university in Rochester, New York, United States
Livingston	township in New Jersey, United States
University of California, San Francisco	university
Madison County	county in New York, United States
Marquette County	county in the Upper Peninsula of Michigan, Unites States
Duluth	conty seat in Saint Louis County, Minnesota, United States
MIT Sloan School of Management	business school of the Massachusetts Institute of Technology
Baltimore metropolitan area	No description defined
University of San Diego	private university in San Diego, California, United States
School of Visual Arts	university
Lafayette	fourth-largest city in Louisiana
Cleveland Institute of Music	No description defined
New York University Tandon School of Engineering	school of New York University
City College of New York	senior college of the City University of New York (CUNY) in New York City
University of Georgia	public university located in Athens, Georgia, United States
Columbia County	county located in the U.S. state of New York
Garland	city in Texas
Cecil County	county in Maryland, United States
Rice University	university in Houston, Texas, USA
Kanawha County	county in West Virginia, United States
Pennsylvania State University	public university In State College and multiple campuses in Pennsylvania, United States
Florida International University	university
George Washington University	university in Washington, D.C.
Salisbury	city in southeastern Maryland, United States
Hudson County	county in New Jersey
St. Joseph	county seat of Buchanan County, Missouri, United States
Hunterdon County	county in New Jersey
Palm Beach County	county in Florida, United States of America
St. Louis	city and port in the U.S. state of Missouri
Topeka	capital city of the state of Kansas, United States; county seat of Shawnee County, Kansas
Wyoming	state of the United States of America
Council Bluffs	City in Iowa
Passaic	city in Passaic County, New Jersey, United States
Paterson, New Jersey	city in and the county seat of Passaic County, New Jersey
Joseph Sargent	American film director
Empire State Building	skyscraper located in Midtown Manhattan, New York City
Franklin & Marshall College	college in Lancaster, Pennsylvania, United States
La Crosse County	county in Wisconsin, United States
Columbia College Chicago	No description defined
Ridgefield	town in Connecticut
Berkshire County	county in Massachusetts
California State University, Fullerton	public university in Fullerton, California, United States, part of the California State University system
Newport News	city in Virginia, United States
Gadsden	city in and the county seat of Etowah County in the U.S. state of Alabama
Marion County	county in Florida, United States of America
Southern University	college located in Baton Rouge, Louisiana
Lake Superior	largest of the Great Lakes of North America
South Dakota	state of the United States of America
University of Missouri	public research university in Columbia, Missouri
Poughkeepsie	city in the state of New York, United States
North Carolina Agricultural and Technical State University	university
Menlo Park	city at the eastern edge of San Mateo County, in the San Francisco Bay Area of California
Seattle	county seat of King County, Washington, United States
Brookline	town in Massachusetts, United States
Binghamton	city in  Broome County, New York, United States
Mansfield	city in U.S. state of Ohio and county seat of Richland County
Box Elder County	county in Utah, United States
California State Polytechnic University, Pomona	university
Riverside	county seat of Riverside County, California, United States
San Mateo	city in San Mateo County, California, United States
Massachusetts	state of the United States of America
Nye County	county in Nevada, United States
Rancho Mirage	city in Riverside County, California, United States
Texarkana	city in Arkansas, USA
Fort Myers	county seat of Lee County, Florida, United States
Monmouth County	county in New Jersey, United States
Fisk University	university in Nashville
Madoff investment scandal	No description defined
Minneapolis	county seat in Hennepin County, Minnesota, United States
Connecticut College	College in New London, Connecticut, United States
Butler University	private university in Indianapolis, Indiana, United States
Middlesex County	county in New Jersey, United States of America
Redlands	city in San Bernardino County, California, United States
Travis County	county in Texas, USA
Columbia	capital city of the state of South Carolina, United States
Culver City	city in Los Angeles County, California, United States
Muncie	county seat of Delaware County, Indiana, United States
State College	borough in Centre County, Pennsylvania, United States
Steubenville	city in and county seat of Jefferson County, Ohio, United States
City University of New York	Public university system in New York City
Yonkers	city in Westchester County, New York, United States
City of Orange Township	township in Essex County, New Jersey, United States
University of Northern Iowa	university in Cedar Falls, Iowa, United States
Hofstra University	university in Nassau County, New York
California State University, Fresno	university
Kennebec County	county in Maine, US
University of Texas at Arlington	university
University of Michigan Law School	law school
Edmund A. Walsh School of Foreign Service	school of international affairs at Georgetown University
Canton	city in Stark County, Ohio, United States
West Virginia University	public university in Morgantown, West Virginia, United States
Lynwood	city in Los Angeles County, California, United States
Rochester	county seat of Monroe County, New York, United States
United States Air Force Academy	military academy near Colorado Springs, Colorado, USA
Oklahoma City	capital city of state of Oklahoma, United States; county seat of Oklahoma County, Oklahoma
Greater Houston	Metropolitan area in Texas, USA
Henderson	city in Nevada
United States Conference of Catholic Bishops	organization
Hawaii	state of the United States of America, located on an archipelago in the Pacific Ocean
Lake Erie	one of the Great Lakes in North America
Radcliffe College	former women's college in Cambridge, Massachusetts
Montgomery	capital city of state of Alabama, United States; county seat of Montgomery County, Alabama
Sherman Oaks	town
Fat Possum Records	record label
Hillsborough County	county in New Hampshire
University of Kentucky	university
contiguous United States	48 states in USA apart from Alaska and Hawaii
University of Memphis	No description defined
Greenwich Village	neighborhood in Manhattan
Pomona College	private liberal arts college in Claremont, California, USA
Franklin	county seat of Williamson County, Tennessee, United States
Jackson State University	No description defined
Greenwood	county seat of Leflore County, Mississippi, United States
Butte County	county in California, United States
Los Angeles Unified School District	California school district serving almost all of Los Angeles and surrounding areas
Calaveras County	county in California, USA
Pontiac	city in Michigan, USA
Eastern Time Zone	time zone observing UTC - 5 during standard time and UTC - 4 during daylight saving time
University of Chicago Law School	law school
Nome Census Area	census tract
Orange County	county in Florida, United States of America
Dallas Theological Seminary	seminary in Dallas, Texas
Harvard Graduate School of Design	No description defined
Louisiana Tech University	university in Ruston, Louisiana, USA
Bob Jones University	No description defined
Elgin	city in Cook and Kane counties in the northern part of the U.S. state of Illinois
Florida	state in the United States
Gwinnett County	county in Georgia, United States
California Institute of the Arts	university located in Valencia, in Los Angeles County, California
Bradley University	private university in Peoria, Illinois
West Orange	township in Essex County, New Jersey, United States
Sacramento	county seat in Sacramento County, California, USA and California federated state capital city
Pace University	private university in the New York metropolitan area
Mobile County	county in Alabama, United States
Downey	city located in southeast Los Angeles County
Oxford County	county in Maine, US
Franklin County	county in New York, United States
Texas A&M University	public research university in College Station, Texas, United States
Chesapeake	city in Virginia, United States
Boca Raton	city in Florida, USA
Davidson County	county in Tennessee, United States
Rockville	city in Maryland, United States
Bethesda	unincorporated community in Montgomery County, Maryland, United States; suburb of Washington, D.C.
Rhode Island School of Design	Private art and design college in Providence, Rhode Island
Wesleyan University	private liberal arts college in Middletown, Connecticut
Milwaukee	county seat of Milwaukee County, Wisconsin, United States
Wichita Falls	city in Texas, United States of America
San Bernardino County	county in California, USA
Nevada	state of the United States of America
University of California, Davis	public university located in Davis, California, United States
Indianapolis	county seat in Marion County, Indiana, USA and Indiana federated state capital city
Tillamook County	county in Oregon, United States
University of California, Santa Cruz	public University of California campus in Santa Cruz
Rockford	county seat of Winnebago County, Illinois, United States
Little Rock	county seat city in Pulaski County, Arkansas, USA and Arkansas federated state capital city
Santa Ana	county seat of Orange County, California, United States
Yale University	private research university in New Haven, Connecticut, United States
Tallahassee	capital city of state of Florida, United States; county seat of Leon County, Florida
Nebraska	state of the United States of America
Helena	county seat in Lewis and Clark County, Montana, USA and Montana federated state capital city
Charlotte	county seat of Mecklenburg County,  North Carolina, United States
Trenton	county seat in Mercer County, New Jersey, USA and New Jerseys federated state capital city
Hackensack, New Jersey	city and county seat of Bergen County, New Jersey, United States
Springfield	city in Missouri, United States
Dallas	county seat of Dallas County, Texas, United States; fourth largest metropolitan area in the United States
Virginia Beach	city in Virginia, United States
DeKalb County	county in Georgia, United States
University of South Dakota	public research university located in Vermillion, South Dakota
Whatcom County	county in the U.S. state of Washington
Amherst	town in Massachusetts
Alexandria	parish seat of Rapides Parish, Louisiana, United States
Midland	city in Michigan, USA
San Luis Obispo County	county in California, United States
San Diego State University	public research university in San Diego, USA
Duke University	private university in Durham, North Carolina, United States
Bard College	private liberal arts college in Annandale-on-Hudson, New York
Gettysburg	borough and the county seat of Adams County in the U.S. state of Pennsylvania
Lynn	city in Essex County, Massachusetts, United States
Hidalgo County	county in Texas, United States
Wilmington	county seat city in New Hanover County, North Carolina, United States
Lawrence	city in Massachusetts, United States
Springfield	county seat of Hampden County, Massachusetts, United States
Yale College	undergraduate liberal arts college of Yale University
Case Western Reserve University	university in Ohio, United States
Reed College	private liberal arts college located in the U.S. state of Oregon
Haverhill	city in Massachusetts
Washington County	county in Maine
California	state of the United States
Harlem	group of neighborhoods in Manhattan, New York
Morgan State University	university in  Baltimore, Maryland, United States
Richmond	city in California, United States of America
Tompkins County	county in New York
University of Tulsa	No description defined
Great Falls	town in Cascade County, Montana, United States
Southern Illinois University Carbondale	public university in Carbondale, Illinois, USA; flagship of the SIU system
Chisago County	county in Minnesota, United States
Sioux Falls	city in South Dakota, United States of America
San Rafael	city and the county seat of Marin County, California, United States of America
Outagamie County	county in Wisconsin, United States
Miami University	public research university located in Oxford, Ohio, United States
Northridge	neighborhood of Los Angeles, California, United States
Collin County	county in Texas, USA
Sedgwick County	county in the U.S. state of Kansas
Portland metropolitan area	No description defined
University of Nevada, Las Vegas	public research university in Paradise, Nevada, USA
Furman University	private liberal arts college in Greenville, South Carolina, United States
University of Southern California	private research university in Los Angeles, California, United States
Tennessee	state of the United States of America
Anderson	city in South Carolina
Tazewell County	county located in the U.S. state of Illinois
Kankakee	city in Kankakee County, Illinois, United States
Tupelo	city in Lee County, Mississippi
Indian River County	county in Florida, United States of America
Franklin County	county in Massachusetts
Delaware	state of the United States of America
Las Vegas	city in and county seat of Clark County, Nevada, United States
Fairbanks	city in Alaska, USA
Arkansas	state of the United States of America
Sedona	city in Arizona, USA
Coral Gables	city in Miami-Dade County, Florida, United States; suburb of Miami, Florida
New Mexico	state of the United States of America
New Jersey	state of the United States of America
Frankfort	city in Kentucky
Bloomington	city in Hennepin County, Minnesota, United States
Baton Rouge	capital of the state of Louisiana, United States; parish seat of  East Baton Rouge Parish, Louisiana
Hayward	city in Alameda County, California, United States
Winston-Salem	city in Forsyth County, North Carolina
Alabama	state of the United States of America
Perth Amboy	city in New Jersey
Norwalk	city in Fairfield County, Connecticut, United States
James Madison University	university
Fairfield County	county in Connecticut, United States of America
University of Hartford	university in Connecticut, United States
Stanford Law School	No description defined
New York metropolitan area	most populous metropolitan area in the United States
Williams College	liberal arts college in Massachusetts
Syracuse	county seat of Onondaga County, New York, United States
Contra Costa County	county in California, USA
Mountain Time Zone	time zone of North America
Plainfield	city in Union County, New Jersey, United States of America
Fairfield University	university located in Fairfield, Connecticut
Pennsylvania Academy of the Fine Arts	museum and art school in Philadelphia, Pennsylvania
Niagara Falls	city in New York, USA
Manhattan School of Music	music school in New York City
Clark Atlanta University	No description defined
Jackson	city located in the U.S. state of Michigan
Beaumont	county seat of Jefferson County, Texas, United States
Bloomington	county seat of Monroe County, Indiana, United States
Cook County	county in Illinois, United States
Montana State University - Bozeman	No description defined
Staten Island	borough of New York City, New York, United States
Beloit College	No description defined
Ohio	state of the United States of America
Claremont	city on the eastern edge of Los Angeles County, California
Mariposa County	county in California, USA
Tuskegee University	private, historically black university located in Tuskegee, Alabama, USA
New Orleans metropolitan area	No description defined
Rensselaer Polytechnic Institute	private research university in Troy, New York, United States
New England Conservatory of Music	oldest independent school of music in the United States
Minden	small city in and parish seat of Webster Parish, Louisiana, United States
St. Charles County	county in Missouri, United States
Morris County	county in New Jersey
Ninth grade	No description defined
Loudoun County	county located in the United States Commonwealth of Virginia
San Francisco Bay Area	metropolitan area in California, United States
Clackamas County	county in Oregon, United States
Virginia Military Institute	state-supported military college  in Lexington, Virginia, USA
Allegany County	county in Maryland, United States
Elizabeth	city in state of New Jersey, United States
Naples	county seat of Collier County, Florida, United States
St. Petersburg	city in Pinellas County, Florida, United States
Oregon State University	public university in Corvallis, Oregon, United States
San Luis Obispo	county seat of San Luis Obispo County, California, United States
Moscow	City in Idaho, United States
Dorchester	neighborhood in Boston, Massachusetts, United States
Huntington Beach	seaside city in Orange County, California, United States
Quincy	county seat of Adams County, Illinois, United States
University of Toledo	No description defined
Massachusetts Institute of Technology	research university in Cambridge, Massachusetts, United States
Amherst College	liberal arts college in Massachusetts
Madison	city in and state capital of Wisconsin, United States
Charleston	capital city of state of West Virginia, United States; county seat of Kanawha County, West Virginia
Tarrant County	county in Texas, USA
New England	region of the United States
Tulane University	private university in New Orleans, Louisiana, United States
Sonoma State University	university
Towson University	university
Urbana	county seat of Champaign County, Illinois, United States
Kenosha	city in and county seat of Kenosha County, Wisconsin
Michigan State University	public research university in East Lansing, Michigan, United States
Norristown	county seat of Montgomery County, Pennsylvania, United States
Purdue University	public research university in West Lafayette, Indiana, United States
Jackson County	county in Alabama, United States
Santa Cruz County	county in California
St. Bonaventure University	university
Berkeley	city in Alameda County, California, United States
Danbury	city in Connecticut
Pasadena City College	community college located in Pasadena, California, USA
Sonoma County	county in California
Cleveland State University	university
Laguna Beach	city in California
Hampshire County	county in Massachusetts
DuPage County	county in Illinois
Spartanburg County	county in South Carolina, United States
Hancock County	county located in the U.S. state of Maine
Portage County	county in Ohio, US
Hawaiian Islands	archipelago in the North Pacific Ocean, currently administered by the US state of Hawaii, with the exception of Midway Island
Somerset County	county in New Jersey
Lucas County	county in Ohio, United States
Lake County	county in California, United States
Harvard College	main undergraduate school of Harvard University in Cambridge, Massachusetts
Mosul	city in northern Iraq and capital of Nineveh Province
Glendale	city in Los Angeles County, California, United States
Mahoning County	county in Ohio, United States
Lake County	county in Illinois, United States
Oxnard	city in Ventura County, California, United States
Stevens Institute of Technology	higher education institute in Hoboken, New Jersey
Port Arthur	city in Jefferson County, Texas, United States
Hampshire College	private liberal arts college in Amherst, Massachusetts, United States
New York University School of Law	law school of New York University in Manhattan, New York, United States
Harris County	county in Texas
Everett	city in Washington, United States of America
West Chester	borough in Chester County, Pennsylvania, United States
Central Time Zone	time zone
Stuyvesant High School	No description defined
Dearborn	city in Michigan, USA
Ontario County	county in New York, United States
Irvine	city in California, United States
Orange County	county in New York, United States
Oswego County	county in New York, United States
New York City	city in state of New York, United States
Williamsport	county seat of Lycoming County, Pennsylvania, United States
West Palm Beach	county seat of Palm Beach County, Florida, United States
Bowdoin College	private liberal arts college in Brunswick, Maine
Eau Claire	city in Wisconsin
Bangor	city in Penobscot County, Maine, USA
Montclair State University	public university in New Jersey, United States
Coronado	city in California
Traverse City	city
Ventura	city in California, United States of America
Staunton	independent city in Virginia, United States
Richmond	city in Indiana, United States
Savannah	county seat of Chatham County, Georgia, United States
Pima County	county in Arizona, United States of America
Cochise County	county in Arizona, United States
Washington County	county in Pennsylvania, United States
Bend	city in Oregon, United States of America
Gila County	county in Arizona, United States
Allentown	county seat city in Lehigh County, Pennsylvania, USA
Navajo County	county in Arizona, United States
San Jose	county seat of Santa Clara County, California, United States
Litchfield	town in Connecticut, United States
Palo Alto	city in Santa Clara County, California, United States
Macon	city in Georgia, United States of America
Trinity University	university in San Antonio, Texas
Louisville metropolitan area	No description defined
University of Mississippi	university
Suffolk County	county in Massachusetts
Westwood Village Memorial Park Cemetery	cemetery in the Westwood Village area of Los Angeles, California, United States
Citrus County	county in the U.S. state of Florida
Worcester County	county in Massachusetts
Forest Lawn Memorial Park	cemetery in the Hollywood Hills neighborhood, Hollywood district, Los Angeles, California, United States
Forest Lawn Memorial Park	cemetery in Glendale, California, United States
Sioux City	city in Iowa, United States of America
South Carolina	state of the United States of America
Stark County	county in Ohio, United States
Murfreesboro	city in Tennessee, United States of America
Lackawanna County	county in Pennsylvania, United States
Tyler	city in east Texas, USA
Redding	city in Shasta County, California, United States
Illinois State University	public university in Normal, Illinois
Princeton University	private Ivy League research university in Princeton, New Jersey, United States
Greater Los Angeles Area	large urban region in the United States
Huntsville	county seat of Madison County, Alabama, United States
Akron	county seat of Summit County, Ohio, United States
Villanova University	No description defined
University of Montana	public research university located in Missoula, Montana
University of Florida	public research university in Gainesville, Florida, United States
Santa Fe	capital of state of New Mexico, United States; county seat of Santa Fe County, New Mexico
Inglewood	city in California
Colgate University	private liberal arts college
San Francisco	consolidated city-county in California, United States
Middletown	city in Connecticut
Santa Monica	beachfront city in Los Angeles County, California, United States
Weber County	county in Utah
Tuolumne County	county in California, USA
Kansas	state of the United States of America
South Carolina State University	public university in South Carolina, USA
McNeese State University	university
University of Pennsylvania Law School	No description defined
Jefferson County	county in Kentucky, United States
Hanover	town in Grafton County, New Hampshire, United States
Escondido	city in California
Stockton	county seat of San Joaquin County, California, United States
Waltham	city in Middlesex County, Massachusetts, United States
Portsmouth	city in Virginia, United States
Reno	county seat of Washoe County, Nevada, United States
McHenry County	county in Illinois, United States
New Castle County	county in Delaware, United States
Gettysburg College	liberal arts colleges in the United States
Deschutes County	county in Oregon
Maricopa County	county in Arizona, United States
Marion County	county located in the Willamette Valley region of the U.S. state of Oregon
Dayton	county seat of Montgomery County, Ohio, United States
Grand Forks	city in North Dakota, United States
Pawtucket	city in Rhode Island
Northwestern University	private research university with campuses in Evanston and Chicago, Illinois, United States
Vermont	state of the United States of America
Delaware County	county in New York, United States of America
Western Illinois University	university
Galveston	county seat of Galveston County, Texas, United States; port and coastal city
Fort Worth	county seat of Tarrant County, Texas, United States
Washington State University	public university in Pullman, Washington, USA
Middlebury College	private liberal arts college located in Middlebury, Vermont in the United States
Hartford	city in Hartford County, Connecticut, United States, USA and Connecticut federated state capital city
Armstrong County	county in Pennsylvania, United States
Naperville	city in Illinois
Fort Smith	city in Arkansas, USA
East River	tidal strait in New York City
New York University Stern School of Business	university
Gainesville	county seat of Alachua County, Florida, United States
Summit County	county in Ohio
Thousand Oaks	city in California
Long Branch	city in New Jersey, United States
Lancaster	city in central Lancaster County, Pennsylvania, United States
Brockton	city in Massachusetts
Pasadena	city in Los Angeles County, California, United States
Roosevelt University	No description defined
Santa Barbara	city in California
Pittsburgh	county seat in Allegheny County, Pennsylvania, USA
Myrtle Beach	coastal city in South Carolina, United States
Henrico County	county in Virginia
Birmingham	county seat of Jefferson County, Alabama, United States
Missouri State University	public university in Springfield, Missouri
Fiorello H. LaGuardia High School	No description defined
St. Olaf College	four-year Lutheran liberal-arts college in Northfield, Minnesota
St. John's University (New York City)	university in New York, USA
Concord	town in Middlesex County, Massachusetts, United States
Springfield	county seat in Sangamon County, Illinois, USA and Illinois federated state capital city
Greenwich	town in Fairfield County, Connecticut, United States
Santa Clara County	county in California, United States
Palm Desert	city in California
Brazoria County	county of Texas, United States
Clark County	county in the U.S. state of Washington
Miami Beach	city in Miami-Dade County, Florida, United States
Key West	county seat city of Monroe County, Florida, United States; island in Florida Keys
Plymouth County	county in Massachusetts
Fordham University School of Law	No description defined
Hammond	city in Indiana
Belmont University	No description defined
Palm Beach	town in Palm Beach County, Florida, United States
Grove Street Cemetery	No description defined
Springfield	county seat of Clark County, Ohio, United States
Cooper Union	college in New York City
The New School	university in New York City, located mostly in Greenwich Village
Wilmington	county seat of New Castle County, Delaware, United States
Bethel Census Area	census area located in the U.S. state of Alaska
Berklee College of Music	independent college of contemporary music  in Boston, Massachusetts, United States
Colorado College	private liberal arts college in Colorado Springs, Colorado, United States
Wood County	county in Wisconsin, USA
Essex County	county in Massachusetts, USA
Fort Collins	municipality and county seat of Larimer County, Colorado, United States
Decatur	city in Morgan and Limestone counties, Alabama, United States
Alameda	city in Alameda County, California, United States
Tampa	county seat of Hillsborough County, Florida, United States
Stanford University	private research university located in Stanford, California, United States
Allegheny County	county in the southwestern part of the U.S. state of Pennsylvania
Lake County	county in Ohio, United States
Mills College	liberal arts and sciences college located in the San Francisco Bay Area
Glens Falls	city in New York, USA
Baylor University	private university in Waco, Texas, United States
Falls Church	city in Virginia, United States
University of Denver	private university in the Rocky Mountain Region of the United States
University of California, Riverside	public research university
Burlington	city in Chittenden County, Vermont, United States
Bridgeport	county seat city of Fairfield County, Connecticut, United States
Columbia University	private Ivy League research university in New York City
Mississippi River	largest river system in North America
DePauw University	private liberal arts college in Greencastle, Indiana, United States
Oral Roberts University	interdenominational, Christian, comprehensive liberal arts university
Kenyon College	private liberal arts college in Gambier, Ohio, United States
University of New Mexico	public research university in Albuquerque, New Mexico, United States
Columbia University College of Physicians and Surgeons	No description defined
North Carolina State University	public research university in Raleigh, North Carolina, United States
Battle Creek	city in Calhoun County, Michigan, United States
John F. Kennedy International Airport	international airport in New York, United States
Atlantic County	county in New Jersey, United States
Lawrence	city in Kansas, United States
Inyo County	county in California
California State University	public university system in California, United States
Metro Detroit	metropolitan area in Michigan, USA
Waukesha	city in Waukesha County, Wisconsin
Bozeman	town in Gallatin County, Montana, United States
Peoria County	county in Illinois, United States of America
Riverside County	county in California, United States of America
Sierra Nevada	mountain range in California, USA
College of the Holy Cross	liberal arts college in Massachusetts, United States
Detroit	most populous city in Michigan, United States; county seat of Wayne County
Queens	borough of New York City, New York, United States
Hollywood	district in Los Angeles, California, United States
Chicago metropolitan area	Metropolitan area in Illinois, United States; also extending into Indiana and Wisconsin
San Antonio	county seat city in Bexar County, Texas, USA
Racine	city in and county seat of Racine County, Wisconsin, United States
Santa Clara	city in Santa Clara County, California, United States
Teachers College	graduate school in Columbia University
Mountain View	city in Santa Clara County, California, United States
Golden Gate Bridge	suspension bridge on the San Francisco Bay
Santiago de Cuba	city in Cuba
Windsor County	county located in the U.S. state of Vermont
Kern County	county in California, USA
Sauk County	county in Wisconsin, United States
Yale Divinity School	No description defined
Texas Southern University	university
Disneyland	American theme park in California owned by The Walt Disney Company
Albany	county seat of Dougherty County, Georgia, United States
Muskogee	City in Oklahoma
Wayne State University	American public research university located in Detroit, Michigan
Harvard Business School	business school in Boston, Massachusetts
Green Bay	city in and county seat of Brown County, Wisconsin
University of South Florida	public university in Tampa, Florida, United States
Bayonne	city in New Jersey, USA
Selma	city in Alabama, USA
Rocky Mountains	mountain range in North America
Cornell University	private university in Ithaca (New York, US)
Ann Arbor	county seat of Washtenaw County, Michigan, United States
Medford	city in Middlesex County, Massachusetts, United States
Humboldt County	county in California, USA
Franklin County	county in Pennsylvania, United States of America
Malden	city in Middlesex County, Massachusetts, United States
Utah County	county in Utah
Towson	suburb of Baltimore, Maryland, United States
Bryn Mawr College	women's liberal arts college in Bryn Mawr, Pennsylvania, US
Cayuga County	county in New York, United States
Anderson	county seat of Madison County, Indiana, United States
Polk County	county in Iowa, United States
Colorado Springs	county seat of El Paso County, Colorado, United States
New Haven County	county in Connecticut
Creighton University	a Jesuit and Catholic university located in Omaha, Nebraska in the United States
Los Angeles County	county in California, United States of America
Cattaraugus County	county in New York, United States
Swarthmore College	liberal arts college in Swarthmore, Pennsylvania
Marshall University	university
Skagit County	county in the U.S. state of Washington
Charleston County	county in South Carolina, United States of America
Snohomish County	county in the U.S. state of Washington
University of Dayton	university in Dayton, Ohio, USA
Dartmouth College	university and liberal arts college in Hanover, New Hampshire, United States
Augusta	city in Richmond County, Georgia
Norwich University	Military college in vermont
San Joaquin County	county in California, USA
Harvard University	private research university in Cambridge, Massachusetts, United States
Denison University	private college in Glenville, Ohio, United States
Bexar County	county in Texas, USA
Plymouth	county seat town in Plymouth County, Massachusetts, United States
Arcadia	city in California
Ogden	city in Weber County, Utah, USA
Casper	city in Natrona County, Wyoming, USA
Moline	city in Illinois
Pittsburgh metropolitan area	No description defined
Saint Joseph's University	private, coeducational Roman Catholic Jesuit university
Trumbull County	county in Ohio, United States
Southfield	city in Oakland County, Michigan, United States
Clearwater	county seat of Pinellas County, Florida, United States
New Hampshire's 1st congressional district	No description defined
Grinnell College	liberal arts college in Iowa, United States
Santa Clara University	private non-profit Jesuit university located in Santa Clara, California
Saginaw	county seat of Saginaw County, Michigan, United States
University of Louisiana at Monroe	university
Concord	city in California, United States
Hempstead (village), New York	No description defined
Bates College	university in Maine, United States
Greenville County	county in South Carolina, United States
Sarah Lawrence College	private liberal arts college in the United States
University of California, Berkeley	public research university in Berkeley, California, United States
Suffolk County	county in New York
Ohio University	university
Fairleigh Dickinson University	American university
Western Michigan University	public university located in Kalamazoo, Michigan, United States
Stanford Graduate School of Business	professional school of Stanford University, in Stanford, California
Champaign County	county in Illinois, United States
Warren County	county in New Jersey
University of Miami	private university in Coral Gables, Florida, United States
Toledo	county seat of Lucas County, Ohio, United States
Barnard College	private women's liberal arts college in the United States
Napa County	county in California, United States
Covington	city in Kentucky, US
Ames	city in Iowa, United States
Somerset County	county in Pennsylvania, United States
Northwestern University School of Law	No description defined
Norman	city in Oklahoma, United States of America
Oklahoma	state of the United States of America
Galveston County	county in Texas, USA
Tufts University	private research university in Medford/Somerville, Massachusetts
Hamilton County	county in Ohio, US
North Dakota	state of the United States of America
Kansas City	city in Jackson, Clay, Cass, and Platte counties, Missouri, United States
Clemson University	university in South Carolina, United States
Greene County	county in Ohio, United States
Davenport	county seat of Scott County, Iowa, United States
Logan	city in Cache County, Utah
Baltimore	city in Maryland, United States
Framingham	town in Massachusetts, United States
Long Beach	city in Los Angeles County, California, United States
Joliet	city in Illinois, United States
Gaston County	county in North Carolina, United States
Carmel-by-the-Sea	city in Monterey County, California
Transylvania University	private university in Lexington, Kentucky, United States
Bennington College	university
Queens College	college in New York City
Provo	city in Utah
Washington County	county in Minnesota
Huntington	town in Suffolk County, New York, United States
Ashtabula County	county in Ohio, US
Newport Beach	city in Orange County, California, United States
Sarasota	county seat of Sarasota County, Florida, United States
Royal Oak	city in Oakland County, Michigan, United States
Hunter College	university
Gyeonggi Province	province in South Korea
Yale School of Medicine	No description defined
Los Gatos	incorporated town in Santa Clara County, California
Atlantic City	city in Atlantic County, New Jersey, United States
Columbus	city in Muscogee County, Georgia, United States
St. Louis County	county located in the U.S. state of Minnesota
Beverly	city in Massachusetts, USA
Rock Island	city in Illinois
Torrance	city in California
Fairfax	city in Fairfax County, Virginia, United States
Columbia College	oldest undergraduate college at Columbia University in New York City
Lake Charles	parish seat of Calcasieu Parish, Louisiana, United States
Van Nuys	district in Los Angeles, California, USA
Beverly Hills High School	major public high school in Beverly Hills, California
Fairfax County	most populated county in Virginia
University of Richmond	university in Richmond, Virginia
Philadelphia	county seat city in Philadelphia County, Pennsylvania, USA
Oakland	port city and county seat of Alameda County, California, United States
Red Bank	borough in Monmouth County, New Jersey, United States
Kent County	county in Michigan, United States
Kitsap County	county in the U.S. state of Washington
Nashua	city in New Hampshire
King County	county in the U.S. state of Washington
Florence	county seat of Florence County, South Carolina, United States
College of William & Mary	public research university located in Williamsburg, Virginia
Marin County	county in California, USA
Salt Lake County	county in Utah, United States
Kent State University	university
Culinary Institute of America	cooking school
Haverford College	college in Pennsylvania
Fort Bend County	county in Texas
Union Theological Seminary	independent, ecumenical, Christian seminary in New York City
Walnut Creek	city in California
Glen Cove	city in Nassau County, New York
University of Louisiana at Lafayette	university
Nassau County	county in New York
Hilo	county seat of Hawaii County, Hawaii, United States
Maine	state of the United States of America
Ocala	county seat of Marion County, Florida, United States
UC Berkeley School of Law	law school
Sullivan County	county in New York
Providence County	county in Rhode Island
Santa Monica College	college
University of Texas at El Paso	public research university in El Paso, Texas
Kentucky	state of the United States of America
University of California, Los Angeles	public research university in Los Angeles, California, United States
Plano	city in Texas
Lexington County	county in South Carolina
Santa Barbara County	county in southern California, U.S.
Virginia Union University	No description defined
Illinois Institute of Technology	university
Park County	county in Wyoming, United States
Greenville	county seat of Pitt County, North Carolina, United States
Loyola University Chicago	university
Hartford County	county in Connecticut
Honolulu	county seat in Honolulu County, Hawaii, USA and Hawaii federated state capital city
California College of the Arts	Art, design, architecture, and writing school located in the San Francisco Bay Area
Michigan	state of the United States of America
Newport	county seat of Newport County, Rhode Island, United States
Natchitoches	small city and the parish seat of Natchitoches Parish, Louisiana, United States
University of Iowa	public research university in Iowa City, Iowa, United States
Richmond	capital city of Commonwealth of Virginia, United States
Whittier	city in Los Angeles County, California, United States
Carson City	capital city of the state of Nevada, United States
Charles County	county in Maryland, United States
California Polytechnic State University	university located in San Luis Obispo, California
Lakeland	city in Polk County, Florida, United States
Indiana	state of the United States of America
Dauphin County	county in Pennsylvania, United States
St. Lawrence County	county in New York, United States
Eureka	principal city and county seat of Humboldt County in California
Carleton College	liberal arts college in Northfield, Minnesota
Tucson	county seat of Pima County, Arizona, United States
La Crosse	city in and county seat of La Crosse County, Wisconsin
Monroe	parish seat of Ouachita Parish, Louisiana, United States
Occidental College	liberal arts college in Los Angeles, California, United States
Salem	city in Marion County and Polk County, Oregion, USA, county seat in Marion County and Oregon federated state capital city
Fayetteville	city in Cumberland County, North Carolina, United States
Art Students League of New York	art school located on West 57th Street in Manhattan, New York City
College of Wooster	No description defined
George Washington University Law School	No description defined
Tuscaloosa	county seat of Tuscaloosa County, Alabama, United States
Corvallis	city in Oregon, USA
Takoma Park	city in Maryland, United States
Washington University in St. Louis	private research university in suburban St. Louis, Missouri, United States
U.S. Route 66	former US highway through Chicago and Los Angeles
Altoona	city in Blair County, Pennsylvania
Lorain	city in Ohio, United States
Lee Strasberg Theatre and Film Institute	drama school
Orange County	county in California, United States
Flagstaff	city in Arizona, USA
Phoenix	Phoenix, Arizona, United States; county seat of Maricopa County, Arizona
Tisch School of the Arts	Performing Arts Institute at New York University in New York, USA
San Diego	city in California
Danville	independent city in the U.S. state of Virginia
Greater Boston	metropolitan area in Massachussetts, New Hampshire and Rhode Island, USA
Oceanside	city in California, United States
East Orange	city in Essex County, New Jersey, United States
Fayetteville	city in Arkansas
Clark University	American private university and liberal arts college in Worcester, Massachusetts
Ulster County	county in New York
Wayne County	county in Michigan
University of Kansas	public research university in Kansas, United States
Paducah	city in Kentucky, USA
Texas Christian University	private university in Fort Worth, Texas, USA
Albuquerque	city in New Mexico, USA
San Francisco State University	university in San Francisco, California
Hobart and William Smith Colleges	No description defined
Hagerstown	city in Maryland, United States
Juilliard School	American performing arts conservatory in New York City
Providence College	American private university in Rhode Island
Billings	city in Montana, United States of America
Evanston	suburban city in Cook County, Illinois, United States
University of Central Florida	public university in Orlando, Florida, United States
Dickinson College	university
Des Moines	county seat city in Polk County, Iowa, USA and Iowa federated state capital city
Harford County	county in the U.S. state of Maryland
Missoula	county seat of Missoula County, Montana, United States
Ramsey County	county in Minnesota, United States of America
University of Virginia School of Law	No description defined
New Britain	city in Connecticut
West Hollywood	city in California
Westport	town in Connecticut
Odessa	city in Texas, United States of America
Davidson College	liberal arts college in Davidson, North Carolina
Spartanburg	county seat of Spartanburg County, South Carolina, United States
Independence	county seat of Jackson County, Missouri, United States
Pennsylvania's 12th congressional district	No description defined
Peoria	county seat of Peoria County, Illinois, United States
Northern Arizona University	public research university located in Flagstaff, Arizona
Scott County	county in Iowa, United States of America
Plumas County	county located in the Sierra Nevada of the U.S. state of California
Oakland County	county in Michigan, USA
Fremont	city in California
University of Northern Colorado	No description defined
Fayette County	county in Pennsylvania, United States
Port Huron	city in Michigan, United States
Syracuse University	university located in Syracuse, New York, United States
California Institute of Technology	private research university located in Pasadena, California
Mono County	county in California
Pasco County	county located in Florida, United States of America
Pinellas County	county in Florida, United States of America
The University of Akron	public research university located in Akron, Ohio, United States
University of Virginia	public research university in Charlottesville, Virginia, United States
Monterey County	county in California, USA
Fontana	city in California, United States of America
Palm Springs	city in Riverside County, California, United States
Wellesley College	private women's liberal arts college in Massachusetts
Los Angeles	county seat of Los Angeles County, United States
Franklin County	county in Ohio, United States of America
contemporary worship music	music genre
Waterbury	city in New Haven County, Connecticut, United States
Atlanta	capital city of state of Georgia, United States; county seat of Fulton County, Georgia
Frederick County	county in Maryland, United States
Oberlin College	private liberal arts college in Oberlin, Ohio, United States
Old Dominion University	university
Aurora	city in Kane County, Illinois, United States
Stony Brook University	public university in Stony Brook, New York, United States
Pine Bluff	city and county seat of Jefferson County, Arkansas, United States
Belleville	city in Illinois
Ithaca	city in New York, USA
Dothan	county seat of Houston County, Alabama, United States
Carnegie Institute of Technology	private university
Sonora	one of the states of Mexico
Grafton County	county in New Hampshire
Rome	county seat of Floyd County, Georgia, United States
Memphis	county seat of Shelby County, Tennessee, United States
Lehigh University	university
Newton	city in Middlesex County, Massachusetts, United States
Tennessee State University	No description defined
Lake Forest	city in Lake County, Illinois, United States
Kingston	city in and the county seat of Ulster County, New York, United States
Pomona	city in Los Angeles County, California, United States
Roanoke	city in Virginia, United States
Pratt Institute	private art college located in Brooklyn, New York, USA
Ridgewood	village in Bergen County, New Jersey, United States
Macalester College	liberal arts college in Saint Paul,  Minnesota, USA
Monroe County	county in New York, United States
Seattle University	university
Durham	county seat of Durham County, North Carolina, United States
University of North Dakota	No description defined
Dutchess County	county in the U.S. state of New York
Washington County	county in Maryland, United States
Knoxville	county seat of Knox County, Tennessee, United States; third-largest city in Tennessee
Iowa	state of the United States of America
University of Cincinnati	public research university in Cincinnati, Ohio
Niagara County	county in New York, United States
University of Utah	public coeducational space-grant research university in Salt Lake City, Utah
Howard County	county located in Maryland
University of Portland	private Catholic university in Portland, Oregon, USA
Tempe	city in Maricopa County, Arizona, United States
East Tennessee State University	university
Centre County	county in Pennsylvania, United States
Art Center College of Design	No description defined
Essex County	county in New Jersey
Montgomery County	county in Maryland, US
Gloucester County	county in New Jersey, United States
Wake County	county in North Carolina, United States of America
Santa Fe County	county in New Mexico, United States
Placer County	county in California, United States
New York Law School	No description defined
Ingham County	county in Michigan, United States
Joplin	city in southern Jasper County and northern Newton County, Missouri, USA
Upland	City in San Bernardino County, California, United States
Boston University School of Law	law school affiliated with Boston University in the USA
York County	county in Maine, United States
Jackson	capital of the state of Mississippi, United States; county seat of Hinds County, MIssissippi
Wheaton	city in DuPage County, Illinois, United States
Parsons The New School for Design	private art and design college located in the Greenwich Village neighborhood of Lower Manhattan in New York City
Dane County	county in Wisconsin, United States of America
Florida State University	university
Hollywood	city in Florida
Montclair	township in Essex County, New Jersey, United States
Georgetown University	private university in Washington, D.C., United States
Brownsville	county seat of Cameron County, Texas, United States
Melbourne	city in Brevard County, Florida, United States of America
Carroll County	county in New Hampshire
Mercer County	county in New Jersey, United States
Oberlin Conservatory of Music	American private college music school
Bethlehem	city in Lehigh and Northampton counties, Pennsylvania, USA
Rensselaer County	county in New York, United States
Georgia Institute of Technology	public research university in Atlanta, Georgia, United States
Weld County	county in Colorado, United States
Chautauqua County	county in New York, United States of America
Beverly Hills	city in Los Angeles County, California, United States
Hamilton College	private college in  Clinton, New York
Association of American Universities	international organization of leading research universities
Onondaga County	county in New York, United States
Albemarle County	county in Virginia, United States
Malibu	city in Los Angeles County, California, United States
Binghamton University	university
Columbia	city in Missouri, United States
Dubuque	town in Iowa, USA
Hennepin County	county in Minnesota, United States
Rockingham County	county in New Hampshire
San Bernardino	city in  San Bernardino County, California, United States
Gary	city in Lake County, Indiana, United States
University at Buffalo, The State University of New York	university with campuses in and around Buffalo, NY and Amherst, NY
Studio City	No description defined
Indiana University	university system, Indiana, U.S.
St. Clair County	county in Illinois
Jersey City	city in New Jersey, United States
Morgantown	county seat of Monongalia County, West Virginia, United States
Jackson County	county in Missouri, United States
Evansville	county seat of Vanderburgh County, Indiana, United States
Eastern Kentucky University	university
Columbia University Graduate School of Journalism	journalism school at Columbia University
Antioch College	college in Yellow Springs, Ohio
Albany County	county in New York, United States
Brooklyn College	senior college of the City University of New York, located in Brooklyn
Washoe County	county in Nevada, United States
Lee County	county in Florida, United States of America
East Carolina University	university
Oahu	Hawaiian island
Fresno County	county in California, USA
Winchester	city in Virginia, USA
Boulder	city in Colorado, United States of America
Queens County	county in New York, United States
Eastern Illinois University	public university in Charleston, Illinois
Lawton	city in Oklahoma
Jamestown	city in Chautauqua County, New York, United States
University of Pennsylvania	private research university in Philadelphia, Pennsylvania
Pulaski County	county in Arkansas
Cameron County	county in Texas, USA
Enid	city in and county seat of Garfield County, Oklahoma, United States
Austin	city in Travis, Hays and Williamson counties, Texas, USA, Travis County seat and Texas federated state capital city
Harvard Medical School	medical school in Boston, MA
Honolulu County	county in Hawaii, United States
Bryn Mawr	census-designated place in Delaware and Montgomery counties, Pennsylvania, United States
Salem	city in Massachusetts
Irving	City in Texas
East St. Louis	city in St. Clair County, Illinois
Cameron Mitchell	actor
Bernalillo County	county in New Mexico, United States
Colorado	state of the United States of America
University of Houston	state research university in Houston, Texas, United States
Silver Spring	unincorporated area and census-designated place in Montgomery County, Maryland
Yeshiva University	university
University of California, Hastings College of the Law	No description defined
Brevard County	county in Florida, United States of America
New London County	county in Connecticut
Northampton	county seat of Hampshire County, Massachusetts, United States
Anaheim	city in California
Morehouse College	college
Rollins College	US university
Montgomery County	county in New York, United States
University of Alabama at Birmingham	public university in Birmingham, Alabama
Drake University	No description defined
Willamette University	private university located in Salem, Oregon
University of California, Santa Barbara	public university near Goleta, California, United States and part of the University of California system
Augusta County	county in Virginia, United States
Northampton County	county in Pennsylvania, United States of America
Emerson College	private coeducational university located in Boston, Massachusetts
Columbus	county seat in Franklin County, Ohio, USA and Ohio federated state capital city
Arlington County	county in Virginia, United States; suburb of Washington, D.C.
Raleigh	capital city of state of North Carolina, United States; county seat of Wake County, North Carolina
Bismarck	county seat in Burleigh County, North Dakota, USA and North Dakota federated state capital city
New Hampshire	state of the United States of America
Providence	county seat in Providence County, Rhode Island, USA and Rhode Islands federated state capital city
Harvard Divinity School	seminary
Long Island University	university
Andover	town in Essex County, Massachusetts, United States
University of North Carolina at Chapel Hill	public research university in Chapel Hill, North Carolina, United States
Carnegie Mellon University	Private research university in Pittsburgh, Pennsylvania, USA
Lincoln University	university in Pennsylvania
Lake Michigan	one of the Great Lakes of North America
Howard University	university in Washington D.C.
Yakima County	county in the U.S. state of Washington
Maui	island of the Hawaiian Islands in the Pacific Ocean
University of Washington	public research university in Seattle, Washington, United States
Reading	county seat of Berks County, Pennsylvania, United States
Stamford	city in Fairfield County, Connecticut, United States
Waco	city in Texas, United States
Genesee County	county in Michigan, United States
Modesto	city in Stanislaus County, California, United States
New Bedford	city in Bristol County, Massachusetts
Amarillo	city in Texas, USA
Ohio Wesleyan University	No description defined
Blair County	county in Pennsylvania, United States
Abilene Christian University	No description defined
Saratoga County	county in New York, United States
Bristol County	county in Massachusetts
University of Wyoming	public university in Laramie, Wyoming
Barnstable County	county in Massachusetts
Muskegon	city in Michigan, United States
El Paso	county seat of El Paso County, Texas, United States
University of Texas at Austin	public research university in Austin, Texas, United States
Sussex County	county in New Jersey
Wake Forest University	university
Vassar College	private, coeducational liberal arts college in Poughkeepsie, New York, in the United States
Indiana University of Pennsylvania	public university in Indiana County, Pennsylvania, United States
Matanuska-Susitna Borough	borough in Alaska, United States
Elmira	city in Chemung County, New York, USA
La Jolla	neighborhood in San Diego, California, United States
children's music	music mainly intended for children
Montgomery County	county in Texas, US
Erie	county seat of Erie County, Pennsylvania, United States
Yavapai County	county in Arizona, United States
Vallejo	city in Solano County, California, United States
Hampton University	historically black university in Virginia
Essex County	county in New York, United States
Luzerne County	county in Pennsylvania, United States of America
Owensboro	county seat of Daviess County, Kentucky, United States
Milwaukee County	county in Wisconsin, United States
Maui County	county located in the U.S. state of Hawaii
Newark	most populous city in the state of New Jersey,  United States; county seat of Essex County, New Jersey
twelfth grade	No description defined
Nathanael Greene	American general in the American Revolutionary War
Nantucket	island, county, and town in Massachusetts, United States
University at Albany	state university in Albany, New York
Exeter	town in Rockingham County, New Hampshire, United States
Cornell Law School	law school
Hamilton County	county in Tennessee, United States
Seattle metropolitan area	No description defined
Boston University	private research university in Boston, Massachusetts, United States
Annapolis	county seat in Anne Arundel County, Maryland, USA and Maryland federated state capital city
Lafayette	city in Indiana, USA
Summit	city in Union County, New Jersey, United States
Jefferson City	capital city of the U.S. state of Missouri
Eastern Michigan University	comprehensive, co-educational public university in Ypsilanti, Michigan, United States
Pueblo	city in Colorado, United States of America
Auburn	city in Cayuga County, New York
Ypsilanti	city in Washtenaw County, Michigan, United States
Salinas	city in California
Long Island	island in New York
Oklahoma County	county in Oklahoma
Naval Postgraduate School	No description defined
Cobb County	county in Georgia, USA
Lancaster County	county in Pennsylvania, United States
Bloomington	city in Illinois, United States
Fresno	county seat of Fresno County, California, United States
Western Kentucky University	university
University of Arkansas	public research university
Maryland	state of the United States of America
California State University, Los Angeles	university
St. Augustine	county seat of St. Johns County, Florida, United States
Washington	state of the United States of America
Frederick	city in Frederick County, Maryland, United States
Monroe County	county in Florida, United States of America
Trinity College	college in Hartford, Connecticut
Berrien County	county in Michigan, United States
Teaneck	township in New Jersey
Hollywood Walk of Fame	more than 2,500 five-pointed terrazzo and brass stars embedded in the sidewalks along 15 blocks of Hollywood Boulevard and three blocks of Vine Street in Hollywood, California
Fremont County	county in Wyoming, US
Lubbock	county seat of Lubbock County, Texas, United States
Chatham County	county in Georgia, United States
Nashville	capital city of state of Tennessee, United States; county seat of Davidson County, Tennessee
University of Rhode Island	university in Rhode Island, USA
Los Angeles City College	No description defined
Gloucester	city on Cape Ann in Essex County, Massachusetts, in the United States
Compton	city in Los Angeles County, California, United States
Alachua County	county in the U.S. state of Florida
University of Louisville	university in Kentucky
Montgomery County	county in Pennsylvania, United States
East Lansing	city in Ingham and Clinton counties, Michigan, United States
Troy	county seat of Rensselaer County, New York, United States
Santa Rosa	city in Sonoma County, California, United States
Yakima	city in the state of Washington, United States of America
Abilene	city in Texas, USA
Chicago	center of the third largest metropolitan area in the United States; county seat of Cook County, Illinois, United States
Bay City	City in Bay County, Michigan, USA
Cheshire County	county in New Hampshire
UCLA School of Law	No description defined
Baltimore County	county in Maryland, United States
Hamilton	city in Butler County, Ohio, United States
Putnam County	county in New York, United States
Lynchburg	city in Virginia, United States
LaGuardia Airport	airport in Queens, New York City
Lehigh County	county in Pennsylvania, United States of America
Charlestown	neighborhood (former town) of Boston, Massachusetts, United States
Chester	city in Delaware County, Pennsylvania, United States
Carlsbad	city in California, United States of America
University of Oklahoma	public university in Oklahoma, United States of America
Utah State University	university
New York University	private research university in New York, NY, United States
Virginia Commonwealth University	public university in Richmond, Virginia, United States
Athens	county seat of Clarke County, Georgia, United States
Schenectady	county seat of Schenectady County, New York, United States
Centre College	college in Kentucky
North Carolina	state of the United States of America
New Brunswick, New Jersey	city in Middlesex County, New Jersey, United States
glacial lake	lake formed by a melted glacier
Louisville	county seat of Jefferson County, Kentucky, United States
Allegany County	county in New York, United States
Spelman College	No description defined
Olympia	county seat in Thurston County, Washington, USA and Washington federated state capital city
Cass County	county in North Dakota, United States of America
Jackson	city in Madison County, Tennessee, United States
Midland	county seat of Midland County, Texas, United States
Alabama State University	university
McLean	community in Fairfax County, Northern Virginia, USA
Litchfield County	county in Connecticut
Fordham University	American university
Hot Springs	county seat city in Garland County, Arkansas, USA
Otsego County	county in New York, United States
Portsmouth	city in Ohio
Chico	city in Butte County, California, United States
Auburn University	public university in Auburn, Alabama, United States
Cranston	city in Rhode Island
Oregon	state of the United States of America
Lima	city in Ohio, United States
Hillsboro	city in the U.S. state of Oregon
Rhode Island	Eastern coastal state of the United States of America
Solano County	county in California, United States of America
Davis	city in Yolo County, California, USA
Charleston	county seat of Charleston County, South Carolina, United States; oldest city in South Carolina
Johnson County	county in Iowa, US
Logan County	county in Ohio
Louisiana	state of the United States of America
Union County	county in New Jersey
Quincy	city in Massachusetts
Elko County	county in Nevada, United States
Okanogan County	county in the U.S. state of Washington
Lexington	independent city, separate from but surrounded by Rockbridge County in the Commonwealth of Virginia, US
American University	private liberal arts and research-based university in Washington, D.C.
Hoboken	city in Hudson County, New Jersey
School of the Art Institute of Chicago	independent school of art and design
Mercer County	county in Pennsylvania, United States
Boise	county seat in Ada County, Idaho, USA and Idaho federated state capital city
Allen County	county in Indiana, United States
Calvin College	No description defined
Brunswick	city in Georgia, United States
University of South Carolina	university in Columbia, SC
Meridian	city in and the county seat of Lauderdale County, Mississippi, United States
Norfolk	city in commonwealth of Virginia, United States
College Park	city in Prince George's County, Maryland
Petaluma	city in Sonoma County, California
Livonia	city in Wayne County, Michigan, United States
Mount Vernon	city in New York, USA
The Citadel, The Military College of South Carolina	well-known military college in Charleston, South Carolina
Portsmouth	city in Rockingham County, New Hampshire, USA
Multnomah County	county in Oregon, United States of America
Waterloo	city in Black Hawk County, Iowa, United States
Ithaca College	No description defined
Apache County	county in Arizona, United States
Temple University	public research university in Philadelphia, United States
Pacific Palisades	neighborhood in Los Angeles, California
Cheyenne	county seat in Laramie County, Wyoming, USA and Wyomings federated state capital city
Johns Hopkins University	university in Baltimore, Maryland, United States
Corpus Christi	city in Texas
Grant County	county in the U.S. state of Washington
Augusta	county seat in Kennebec County, Maine, USA and Maine federated state capital city
Guilford County	county in North Carolina, United States of America
Taunton	city in Bristol County, Massachusetts, United States
Portland	county seat of Multnomah County, Oregon, United States
suspension bridge	type of bridge
Oneida County	county in New York, United States
Chapel Hill	town in Orange County, North Carolina, United States
Vicksburg	city in the US state of Mississippi
Waukegan	city and county seat of Lake County, Illinois, United States
San Pedro	community with city of  Los Angeles, California, United States
Loyola University New Orleans	private university in New Orleans, Louisiana, United States
State University of New York at Purchase	No description defined
Newburyport	city in Massachusetts
University of New Hampshire	public research university in New Hampshire
Ball State University	public university in Muncie, Indiana, United States
Broward County	county in Florida, United States of America
Columbia Law School	law school
New Haven	city in New Haven County, Connecticut, United States
Wichita	county seat of Sedgwick County, Kansas, United States
Boston Latin School	first public school in the United States
Johnstown	city in Cambria County, Pennsylvania, United States
University of Alabama	public university located in Tuscaloosa, Alabama, United States
Dallas County	county in Texas, United States of America
Beaufort	city in South Carolina, USA
Bowling Green	city in Kentucky
Cumberland County	county in Maine, United States
Mississippi	state of the United States of America
Woodland Hills	district in the city of Los Angeles, California, United States
Aroostook County	county in Maine, United States
Linn County	county in Iowa, USA
Utica	city in Oneida County, New York, United States
Holyoke	city in Massachusetts, United States
Tarzana	district in Los Angeles, California
Orange	city in Orange County, California, United States
Fulton County	county in Georgia, US
University of Oregon	university
Washington County	county in New York
Bremerton	city in Kitsap County, Washington, United States
Juneau	federated state capital of Alaska, USA
Lake County	county in Florida, United States of America
Fairfield	town in Connecticut, United States of America
Wisconsin	state of the United States of America
Washington County	county in Utah
Brown University	University in Providence, Rhode Island
Fashion Institute of Technology	college of art, business, design, and technology connected to the fashion industry
Texas Tech University	a public research university in Lubbock, Texas, United States
Burbank	city in Los Angeles County, California, United States
Klamath County	county in Oregon
Prince William County	county in Virginia
University of Notre Dame	Catholic university in South Bend, Indiana, United States
Douglas County	county in Oregon
Black Mountain College	College in the United States known for its liberal and fine art education
United States Department of Housing and Urban Development	No description defined
Monterey	city in California, United States
Westmoreland County	county in Pennsylvania, United States
The Bronx High School of Science	high school
Williamsburg	city in Virginia, United States
Montpelier	county seat in Washington County, Vermont, USA, Vermont federated state capital city
Brunswick County	county in North Carolina, United States
Duval County	county in Florida, United States of America
Pinal County	county in Arizona, United States
Buncombe County	county in North Carolina, United States
Jackson County	county in the state of Oregon, United States
Teton County	county in Wyoming, United States
Jamaica	neighborhood of Queens, New York
Fullerton	city in Orange County, California, United States
Cincinnati	city in Ohio, United States; county seat of Hamilton County
Holy Cross Cemetery	cemetery in Culver City, California, United States
Will County	county in Illinois, USA
Merced	county seat of, Merced County, California, United States
Marshall	city in Texas, USA
Greensburg	city of Pennsylvania
Cleveland	city in Ohio, United States
McLennan County	county in Texas, USA
Mendocino County	county in California, USA
Greene County	county in New York, United States
University of North Carolina at Charlotte	public research university in Charlotte, North Carolina, United States
Marion County	county located in the U.S. state of Indiana
Southern California	southern portion of US state of California
Cass County	county in Nebraska, United States of America
Cache County	county in Utah, United States
University of Michigan	public research university in Ann Arbor, Michigan, United States
Union College	college located in Schenectady, New York, United States
Brooklyn	borough of New York City, New York, United States
Danville	city in Kentucky
Sandusky, Ohio	city in the U.S. state of Ohio
New Mexico State University	No description defined
Lowell	city in Massachusetts, United States of America
Scottsdale	city in Maricopa County, Arizona, United States
Warren	city in the U.S. state of Ohio
Florida Atlantic University	A state run higher education institution located in Boca Raton, Florida
Gonzaga University	private Catholic university in Spokane, Washington, USA
Greenville	county seat of Greenville County, South Carolina, United States
Petersburg	city in Virginia, USA
Wheeling	city in West Virginia
Duquesne University	Catholic university in Pittsburgh, Pennsylvania, USA
Weber State University	public university in Ogden, Utah, United States of America
Grambling State University	historically black university in Louisiana
Kansas State University	public university in the state of Kansas
Johnson County	county in Kansas, US
Portland State University	No description defined
University of Texas School of Law	No description defined
Wood County	county in Ohio, United States
Georgia	state of the United States of America
Sussex County	county in Delaware, United States
University of Chicago	private research university in Chicago, Illinois, United States
Lane County	county in Oregon
Camden	city in Camden County, New Jersey, United States
Bradenton	county seat of Manatee County, Florida, United States
Costa Mesa	city
Waukesha County	county in Wisconsin, United States
University of San Francisco	Jesuit Catholic university in San Francisco, California
North Carolina Central University	university
Youngstown	county seat of Mahoning County, Ohio, United States
Washington, D.C.	capital city of the United States
Salt Lake City	county seat in Salt Lake County, Utah, USA and Utah federated state capital city
New London	city in New London County, Connecticut, United States
Prescott	county seat of Yavapai County, Arizona, United States
York	county seat of York County, Pennsylvania, United States
University of Delaware	American university
Fort Wayne	county seat of Allen County, Indiana, United States
Portland	county seat of Cumberland County, Maine, United States
Chattanooga	city in the U.S. state of Tennessee
Colorado State University	public research university in Fort Collins
Columbia River	river in North America; flows from British Columbia, through Washington, and along the Washington-Oregon border to the Pacific Ocean
University of Southern Mississippi	university
Vanderbilt University	private research university in Nashville, Tennessee, United States
Saint Louis University	private research university with campuses in St. Louis, Missouri, and Madrid, Spain
Parkersburg	city
Longview	city in Texas, United States
Greater St. Louis	metropolitan area comprising St. Louis, Missouri, USA and surrounding communities
Jefferson County	county in Ohio, United States
Burlington	city in Des Moines County, Iowa
Lake County	county in Indiana, United States
York County	county in Pennsylvania, United States
St. Louis County	county located in the U.S. state of Missouri
Xavier University	Jesuit university located in Cincinnati, Ohio
Mesa	city in Maricopa County, Arizona, United States
Madison County	county in Alabama, United States
The Wharton School	business school of the University of Pennsylvania
Hampton	independent city in Virginia
San Juan County	county in Utah
Warren County	county in New York
Santa Cruz	city in Santa Cruz County, California
Schuylkill County	county in Pennsylvania, United States
Newburgh (city), New York	city in the state of New York, USA
Clark County	county in Nevada, US
Punahou School	school located in Honolulu CDP, Hawaii
Fond du Lac County	county in Wisconsin, United States
La Salle University	private university in Philadelphia, Pennsylvania, United States
Easton, Pennsylvania	city in Pennsylvania, United States of America
Laredo	border city in Texas, USA
Camden County	county in New Jersey, United States
Lexington	city in Fayette County, Kentucky, United States
Boulder County	county in Colorado, United States
Bergen County	county in New Jersey
Burlington County	county in New Jersey, United States
Pierce County	county in the U.S. state of Washington
Boise State University	public research university in Idaho
Shinto	Japanese traditional folk religion
University of Colorado Boulder	public university in Boulder, Colorado, USA and flagship of the University of Colorado system
American Academy of Dramatic Arts	drama school
Greensboro	city in North Carolina, United States of America
Baldwin County	county in Alabama, United States
Norfolk County	county in Massachusetts
University of California, San Diego	public university in San Diego, California, United States
Jefferson County	county in Alabama, United States
Middlesex County	county in Massachusetts
Louisiana State University	university in Baton Rouge, Louisiana, USA
Erie County	county in New York, United States
Lewiston	city in Androscoggin County, Maine, United States
Chillicothe	city in and the county seat of Ross County, Ohio, United States
University of Nevada	University of Nevada, Reno
Arlington	suburb city of Dallas and Fort Worth, Texas
Beaver County	county in Pennsylvania, United States
Ohio State University	public research university in Columbus, Ohio, United States
Tuscarawas County	county in Ohio, United States
Butte	town in Montana, United States
Virginia	state of the United States of America
Eugene	county seat city in Lane County, Oregon, Oregon, United States
Auburn	city in Lee County, Alabama, USA
Pocatello	city in Idaho
New Trier High School	No description defined
Tulsa	county seat of Tulsa County, Oklahoma, United States
Cupertino	city in Santa Clara County, California in the U.S.
Knox College	college in Galesburg, Knox County, Illinois, USA
Troy University	university in Alabama
Seton Hall University	university
Porter County	county in Indiana, United States
University of Pittsburgh	public research university located in Pittsburgh, Pennsylvania, United States
Wichita State University	university
Iowa State University	public research university in Ames, Iowa, United States
Princeton	borough in Mercer County, New Jersey
Harrisburg	county seat in Dauphin County, Pennsylvania, USA and Pennsylvania federated state capital city
Terre Haute	county seat of Vigo County, Indiana, United States
Valparaiso University	Lutheran university in Indiana
Institute for Advanced Study	postgraduate center in Princeton, New Jersey
Orlando	county seat of Orange County, Florida, United States
Colby College	private liberal arts college located on Mayflower Hill in Waterville, Maine, USA
Curtis Institute of Music	music school
Glendale	City in Arizona
University of Illinois at Chicago	university
University of Connecticut	public research university in Connecticut
Tooele County	county in Utah, United States
Wilkes-Barre	county seat of Luzerne County, Pennsylvania, United States
Somerville	city in Middlesex County, Massachusetts, United States
High Point	city in North Carolina, United States of America
Berks County	county in Pennsylvania, United States
New Rochelle	city in New York, USA
Merrimack County	county in New Hampshire
Mohave County	county in Arizona, United States
Albany	county seat of Albany County, New York, USA and New York federated state capital city
Cape May County	county in New Jersey, United States
Cumberland County	county in New Jersey, United States
Spokane County	county in the U.S. state of Washington
University of Massachusetts Amherst	public university in Massachusetts, USA
Beaufort County	county in South Carolina, USA
Manhattan College	No description defined
Missouri River	major river in the central United States, tributary of the Mississippi
El Dorado County	county in California, USA
Shreveport	parish seat of Caddo Parish, Louisiana, United States
Spokane	county seat of Spokane County, Washington, United States
University of New Orleans	public university in New Orleans, Louisiana; part of the University of Louisiana System
Northern Illinois University	university
Woodlawn Cemetery	cemetery in the Bronx, New York City
Georgia State University	university
Visalia	city in California
Pepperdine University	private university near Malibu, California, USA
Ohio River	river in the eastern United States
Chihuahua	state of Mexico
Alexandria	city in Virginia, USA
College Station	city in Brazos County, Texas
Cuyahoga County	county in Ohio, United States
United States Naval Academy	United States federal service academy
West Virginia	state of the United States of America
Champaign	Champaign County, Illinois, United States
Miami	county seat of Miami-Dade County, Florida, United States
Central Michigan University	public research university in Mount Pleasant, Michigan, United States
Harvard Law School	law school in Cambridge
Yuma	city in Arizona, USA
Venice	beachfront neighborhood in Los Angeles, California
Decatur	county seat of DeKalb County, Georgia, United States
Kellogg School of Management	university
Mecklenburg County	county in North Carolina, United States
St. Cloud	city in Minnesota
Polk County	county in Florida, United States of America
Oklahoma City University	American university
Northwestern State University	No description defined
Pacific Time Zone	North American time zone
Eastman School of Music	music school
San Juan	capital of Puerto Rico
Fredericksburg	city in Virginia, United States
Lycoming County	county in Pennsylvania, United States
Concord	capital city of state of New Hampshire, United States; county seat of Merrimack County, New Hampshire
Appalachian State University	university
Warren County	in Ohio, USA
Cambria County	county in Pennsylvania, United States
New York	state of the United States of America
Imperial County	county in California, United States
Bucks County	county in Pennsylvania, United States
Chandler	city in Arizona
Butler County	county in Pennsylvania, United States of America
Johns Hopkins School of Medicine	academic medical teaching and research arm of Johns Hopkins University
Alameda County	county in California, USA
Sangamon County	county located in the U.S. state of Illinois
Arlington National Cemetery	military cemetery in the United States of America
Arizona	state in the United States of America
Uxbridge	town in Worcester County, Massachusetts
Clinton County	county in Pennsylvania, United States
Coconino County	county in Arizona, United States
Englewood, New Jersey	city in Bergen County, New Jersey, United States
Washington metropolitan area	No description defined
Saint Paul	capital of the state of Minnesota, United States; county seat of Ramsey County, Minnesota
Broome County	county in New York, United States
Northeastern University	private university in Boston, Massachusetts, USA
San Diego County	county in California, USA
California State University, Northridge	university
Marietta	county seat of Cobb County, Georgia, United States
Texas	state of the United States of America
Kent County	county in Delaware, United States
Buffalo	county seat city in Erie County, New York, USA
Boston College	private research university in Chestnut Hill, Massachusetts, United States
Manhattan	city in northeastern Kansas in the United States
Pompano Beach	city in Florida, United States of America
El Paso County	county in Colorado, United States
University of Tennessee	public university in Knoxville, Tennessee, United States
Eagle County	county in Colorado, United States
Hillsborough County	county in Florida, United States of America
Tulare County	county in California, USA
Cambridge	city in Middlesex County, Massachusetts, United States
New Orleans	port city in Orleans Parish, Louisiana, United States
Warwick	city in Kent County, Rhode Island, USA
Ventura County	county in California, United States of America
Lincoln	county seat in Lancaster County, Nebraska, USA and Nebraska federated state capital city
Utah	state of the United States of America
Kane County	county in Illinois
Encino	affluent neighborhood in the San Fernando Valley region of Los Angeles, California
Sandoval County	county in New Mexico, USA
Virginia Tech	university with the main campus in Blacksburg, Virginia
Cumberland County	county in Pennsylvania, United States
Wheaton College	Christian liberal arts college in Wheaton, Illinois
Southern Methodist University	private university in Dallas, Texas, United States
Rocky Mount	city in Edgecombe and Nash counties in the coastal plain region of the U.S. state of North Carolina
Earlham College	No description defined
Fauquier County	county in Virginia, USA
White Plains	city in and county seat of Westchester County, New York, United States
Hudson River	river in New York State, draining into the Atlantic at New York City
San Angelo	city in Texas
Astoria	neighborhood in Queens, New York City
Bowling Green State University	public university in Bowling Green, Ohio, United States
Decatur	city in Macon County, Illinois, United States
Connecticut	state of the United States of America
Anniston	county seat of Calhoun County, Alabama, USA
Lafayette College	liberal arts college
University of Arizona	public university in Tucson, Arizona, United States
Shasta County	county in California, USA
Liberty University	private, Christian university located in Lynchburg, Virginia, United States
Licking County	county in Ohio, United States
Rochester Institute of Technology	No description defined
Grants Pass	county seat of, Josephine County, Oregon, United States
Adelphi University	No description defined
Minnesota	state of the United States of America
Monroe County	county in Pennsylvania, United States
United States Military Academy	federal service academy in West Point, New York, United States
DePaul University	university
Valdosta	county seat of Lowndes County, Georgia, United States
University of North Texas	university
Mount Holyoke College	liberal arts colleges in the United States
Manhattan	borough of New York City, New York, United States
Butler County	county in Ohio, United States of America
Brigham Young University	private research university located in Provo, Utah, United States
Saginaw County	county in Michigan, United States
The Bronx	borough of New York City, New York, United States
Norwich	city in Connecticut, USA
Blue Ridge Mountains	mountain range
Marquette University	private university in Milwaukee, Wisconsin, US
Mercer University	No description defined
