Chicago Cubs	baseball team and Major League Baseball franchise in Chicago, Illinois, United States
Focus Features	art house films division of NBCUniversal
Nashville Predators	hockey team of the National Hockey League
Return specialist	No description defined
Canal+	French television channel
Fukuoka SoftBank Hawks	Nippon Professional Baseball team in the Pacific League
Kasper Schmeichel	footballer
Jim Thorpe	American track and field athlete and baseball player
economics	social science that analyzes the production, distribution, and consumption of goods and services
left fielder	outfielder who plays defense in left field
Atari Games	American former producer of arcade games, and originally part of Atari, Inc.
Hewlett-Packard	American multinational information technology corporation
1995 Major League Baseball draft	baseball draft of amateur players by Major League Baseball
1983 NCAA Men's Division I Basketball Tournament	No description defined
Nickelodeon	American children's cable and satellite television network owned by Viacom through Viacom Media Networks
Universal Records	defunct record label
Telemundo	American Spanish-language network owned by Comcast through NBCUniversal Television Group's Telemundo Enterprises
running back	position in American and Canadian football
Entertainment One Music	independent record label in the United States
yellow	color
American English	set of dialects of the English language spoken in the US
Epitaph Records	record label
Lionel Messi	Argentine footballer
swingman	basketball position
Bosnian War	international armed conflict that took place in Bosnia and Herzegovina between 6 April 1992 and 14 December 1995
Mauricio Pinilla	Chilean footballer
Second Punic War	war between the Roman Republic and Carthage between 218 and 201 BCE
drawing	visual artwork in two-dimensional medium
Pashto	language
Louisville Cardinals men's basketball	College basketball team of the University of Louisville
Minnesota Wild	ice hockey team of the National Hockey League
Lorimar Television	company
chemical engineering	branch of science that applies physical sciences and life sciences together with applied mathematics and economics to produce, transform, transport, and properly use chemicals, materials and energy
Boston Bruins	ice hockey team based in Boston, Massachusetts, United States
1999 NCAA Men's Division I Basketball Tournament	No description defined
Thiago Silva	Brazilian footballer
Yom Kippur War	1973 war between Israel and Egypt and Syria
Michael Jordan	American retired professional basketball player and businessman
aesthetics	branch of philosophy dealing with the nature of art, beauty, and taste
Parlophone	German-British record label
Kansas City Royals	baseball team and Major League Baseball franchise in Kansas City, Missouri, United States
Square	Japanese video game company
Warner Bros.	American producer of film, television, and music entertainment
2007 Major League Baseball draft	baseball draft of amateur players by Major League Baseball
Sony Pictures Classics	film division of Sony Pictures Entertainment
Concord Records	American record label
Namco	Japanese corporation;  video game developer and publisher
safety	American and Canadian football position
Graham Holdings Company	diversified American conglomerate
Punt returner	No description defined
Fox News	No description defined
quarterback	position in gridiron football
1980 NCAA Men's Division I Basketball Tournament	No description defined
Korean Broadcasting System	South Korean radio and television network
North Carolina Tar Heels men's basketball	No description defined
Los Angeles Angels of Anaheim	baseball team and Major League Baseball franchise in Anaheim, California, United States
War of the Sixth Coalition	part of the Napoleonic Wars
FX	American cable television network
Avid Technology	American company specializing in video and audio production technology
Intel	American multinational corporation that manufactures semiconductor chips
strait	narrow, typically navigable waterway that connects two larger, navigable bodies of water
2004 Major League Baseball draft	baseball draft of amateur players by Major League Baseball
Apache Wars	armed conflicts between indigenous peoples and white people in southwestern USA between 1849 and circa 1924
English	West Germanic language originating in England
Craig Rocastle	footballer, soccer player
American International Group	American multinational insurance corporation
Priority Records	record label
third baseman	defensive position in baseball and softball, played on the far left end of the infield near third base
Tennessee Titans	National Football League Franchise located in Nashville, Tennessee
criminology	science about the causes and manifestations of crime
Liberation Tigers of Tamil Eelam	militant organization in Sri Lanka
Irem	video game developer
Ben Foster	English footballer
Dennis Rodman	American basketball player
head coach	senior coach or manager of a sports team
Universal Motown Republic Group	No description defined
Kareem Abdul-Jabbar	American basketball player
Rough Trade Records	British record label
Tampa Bay Buccaneers	American football team
UPN	American broadcast television network in the 1990s and 2000s
Universal Music Group Nashville	No description defined
Hattiesburg	city in Lamar County and Forrest County, Mississippi, United States; county seat of Forrest County, Mississippi
Islamic studies	No description defined
YTV	Canadian English-language Category A cable channel
Matador Records	American record label
2002 NCAA Men's Division I Basketball Tournament	No description defined
2004 NFL Draft	No description defined
War in North-West Pakistan	armed conflict involving Pakistan and armed militant groups
Atlanta Braves	baseball team and Major League Baseball franchise in Atlanta, Georgia, United States
Forward-center	basketball position
Morgan Creek Productions	American film studio
Dany Heatley	Ice Hockey Player
aerospace engineering	branch of engineering
Malayalam	language spoken in India
Los Angeles Kings	hockey team of the National Hockey League
Epic Games	No description defined
Astralwerks	record label owned by Universal Music Group
United Airlines	airline in the United States
Norfolk Admirals	ice hockey team
Sony Pictures Home Entertainment	company
Ottawa Senators	NHL ice hockey team in Ottawa, Ontario, Canada
Buffalo Sabres	hockey team of the National Hockey League
Indo-European languages	family of several hundred related languages and dialects
Sire Records	American record label
Walt Disney Animation Studios	a Walt Disney Company animation studio
Vince Grella	Australian soccer player
Interplay Entertainment	American game developer
Boxer Rebellion	anti-imperialist uprising which took place in China
social science	academic discipline concerned with society and the relationships
art	process of creating things of no intrinsic value but significant extrinsic value through emotional or aesthetic appeal
20th Century Fox	American film studio
medicine	science or practice of the diagnosis, treatment, and prevention of disease
Deion Sanders	All-American college football player, professional football player, defensive back, cornerback, wide receiver
Roy Carroll	Northern Irish footballer
USA Network	U.S. cable television channel
philosophy of science	branch of philosophy concerned with the foundations, methods, and implications of science
project management	initiating, planning, controlling and completing projects
TNT	American cable television channel
Chess Records	record label
St. Louis Cardinals	baseball team and Major League Baseball franchise in St. Louis, Missouri, United States
Time 100	Time Magazine's annual listing of 100 influential people
Berkshire Hathaway	American multinational conglomerate holding company
Cisco Systems	American multinational technology company
Allen Iverson	basketball player
point guard	basketball position
Blizzard Entertainment	video game publisher and developer
Kobe Bryant	American basketball player
Chuck Connors	Athlete and actor
DC Comics	U.S. comic book publisher; part of DC Entertainment, a division of Time Warner.
Sacramento Kings	American professional basketball team based in Sacramento, California
Dimeback	No description defined
Portland Trail Blazers	professional basketball team based in Portland, Oregon
Spanish Civil War	war between the Republicans and the Nationalists in Spain
Cincinnati Reds	baseball team and Major League Baseball franchise in Cincinnati, Ohio, United States
Nine Years' War	major war of the late 17th century fought between King Louis XIV of France, and a European-wide coalition
Milwaukee Brewers	baseball team and Major League Baseball franchise in Milwaukee, Wisconsin, United States
Saitama Seibu Lions	Nippon Professional Baseball team in the Pacific League
Interactive Advertising Bureau	organization
SST Records	record label
Crusades	military campaigns sanctioned by the Catholic Church in the Middle Ages
1984 NCAA Men's Division I Basketball Tournament	No description defined
Seattle Mariners	baseball team and Major League Baseball franchise in Seattle, Washington, United States
Activision Publishing, Inc.	American computer- and video game publisher
Columbia Records	American record label
Dwayne Johnson	American actor and professional wrestler
Chris Pronger	Canadian ice hockey defenceman
UCLA Bruins men's basketball	No description defined
Ford	automotive brand manufacturer
Kansas City Chiefs	National Football League franchise in Kansas City, Missouri
philosophy of mind	branch of philosophy that studies the nature of the mind
Denver Broncos	National Football League franchise in Denver, Colorado
linguistics	scientific study of human language
CBS News	television station
2011 Libyan Civil War	2011 armed conflict in the North African country of Libya
Arizona Cardinals	professional American football franchise
Digital Equipment Corporation	U.S. corporation
Viacom	American global mass media company founded in 2006
Atlanta Falcons	American football team
shortstop	defensive position in baseball and softball played on the left side of the infield between second and third bases
Bad Boy Records	record label
Milwaukee Admirals	ice hockey team
Serbo-Croatian	South Slavic language
EA Sports	brand of Electronic Arts
Fuji Television	Japanese television station
Merck & Co.	American pharmaceutical company and former subsidiary of the German Merck company
mathematics	abstract study of numbers, quantity, structure, relationships, etc.; mathematics can be seen as the search for regularities, and the output of any function is a mathematical pattern
Relativity Media	American media company located in Beverly Hills, California
Jacksonville Jaguars	National Football League franchise in Jacksonville, Florida
Los Angeles Lakers	professional basketball team based in Los Angeles, California.
20th Century Fox Television	TV production company
European theatre of World War I	No description defined
Wikimedia Foundation	USA non-profit charitable organization
DreamWorks	California film studio
Sonic Team	Japanese computer and video game developer
Xbox 360	seventh generation video game console developed by and produced by Microsoft in 2005
Taito Corporation	Japanese company
War on Terror	term applied to an international military campaign that started after 11 September 2001
Jade North	Australian soccer player
forward	association football position played near the opponent's goal
Atlantic Records	American record label
Facebook Inc.	American multinational Internet corporation which runs the social networking website Facebook
Burn Gorman	English actor
2002 Major League Baseball draft	baseball draft of amateur players by Major League Baseball
Albert Jarrett	Footballer
1990 NCAA Men's Division I Basketball Tournament	No description defined
Warner Home Video	home video distribution arm of Warner Bros.
Museum of Modern Art	art museum in Manhattan in New York City, USA
Buffalo Bills	National Football League franchise in Buffalo, New York
Malay	Austronesian language
MTV	American basic cable and satellite television channel
economic history	history focused on economics
Salavat Yulaev Ufa	ice hockey team
PepsiCo	soft drink company
journalism	investigation and reporting of events, issues and trends to a broad audience
Dischord Records	record label
Seattle Seahawks	American football team
Marriott International	company
Texas Rangers	baseball team and Major League Baseball franchise in Arlington, Texas, United States
American Recordings	record label
Amazon.co.jp	No description defined
Regency Enterprises	Los Angeles-based entertainment company
Justin Cochrane	English footballer
Fullback	position in American or Canadian football
Warren Feeney	footballer
Kraft Foods	American grocery manufacturing and processing conglomerate
photography	art, science and practice of creating durable images by recording light or other electromagnetic radiation
Microsoft	American multinational technology corporation
Shaquille O'Neal	American basketball player
music	form of art using sound
Portland Pirates	ice hockey team
Brett Favre	former American football quarterback
Nikon	Japanese multinational corporation headquartered in Tokyo, Japan, specializing in optics and imaging
Avalon Hill	board game company
Seattle Storm	Women's basketball team
Teletoon	Canadian TV Channel
Eidos Interactive	British video game publisher
Data East	Japanese video game developer and publisher (1976 - 2003)
Vietnam War	1959-1975 conflict in Vietnam
DreamWorks Animation	American animation studio
Ocean Software	software development company
East West Records	American record label
TVT Records	No description defined
Tohoku Rakuten Golden Eagles	Nippon Professional Baseball team in the Pacific League
Relapse Records	record label in Upper Darby, Pennsylvania, United States
general manager	oversees a firm's day-to-day business operations
fine art	art developed primarily for aesthetics
1987 NCAA Men's Division I Basketball Tournament	No description defined
Walt Disney Pictures	No description defined
Arizona Diamondbacks	baseball team and Major League Baseball franchise in Phoenix, Arizona, United States
Time Warner	American multinational media conglomerate
Metro-Goldwyn-Mayer	American media company
Rhino Entertainment	American record label
NBC	American television network
New York Yankees	baseball team and Major League Baseball franchise in Bronx, New York, United States
cardinal	color (vivid red)
Mindscape	software publishing company
TLC	U.S. basic cable TV channel
Koei	No description defined
Tokyo Yakult Swallows	Nippon Professional Baseball team in the Central League
Hebrew	Semitic language spoken primarily in Israel
bronze medal	No description defined
Toei Company	No description defined
2005 NCAA Men's Division I Basketball Tournament	No description defined
Chris Wood	New Zealand footballer
Old gold	No description defined
Jive Records	American record label
CBS Radio	one of the largest owners and operators of radio stations in the United States
Haim Saban	Media proprietor
Lamar Odom	basketball player
Super Bowl Most Valuable Player Award	award
Vancouver Canucks	hockey team of the National Hockey League
classics	study of the culture of (mainly) Ancient Greece and Ancient Rome
Polydor Records	multinational record label headquartered in the United Kingdom, owned by Universal Music Group
National League	baseball league, part of Major League Baseball
Felix Bastians	German footballer
Rafael Nadal	Spanish tennis player
Village Roadshow Pictures	company
United Artists	American film studio
Girl Scouts of the USA	No description defined
right fielder	the outfielder in baseball or softball who plays defense in right field
Cyrillic script	alphabetic writing system
Fat Wreck Chords	American record label
Rounder Records	American record label
Hudson Soft	Japanese video game publisher
Raquel Welch	American actress
Mute Records	record label
id Software	American video game development company
Orix Buffaloes	Nippon Professional Baseball team in the Pacific League
Vietnamese	language spoken in Vietnam
Sugar Hill Records	American independent record label
Cleopatra Records	record label
Bandai Co., Ltd.	a Japanese toy making and video game company
BBC Three	television channel operated by the BBC
NBCUniversal	American media and entertainment company
1992 NCAA Men's Division I Basketball Tournament	No description defined
Rank Organisation	British entertainment conglomerate
JVC Kenwood Victor Entertainment	Japanese music label
Cumulus Media Networks	former American radio network
maroon	brownish red colour
Pony Canyon	No description defined
Fortune Global 500	No description defined
HBO	American premium cable and satellite television network
Symantec	company
television film	feature film that is a television program produced for and originally distributed by a television network
Korean	language spoken in Korea
Sega Games	Japanese video game developer and publisher and subsidiary of Sega Sammy Holdings
2004 NBA Draft	No description defined
EA Canada	video game developer
Vodafone	British multinational telecommunications company
Image Comics	US comic book publisher
The Weinstein Company	American mini-major film studio
Second Boer War	war between South African Republic and the United Kingdom
Nine Network	Australian broadcast television network
Goldman Sachs	American multinational investment banking firm
Washington Nationals	baseball team and Major League Baseball franchise in Washington, D.C., United States
2009 NFL season	90th season in the history of the National Football League
V2 Records	British record label
commissioner	title given to a member of a commission or to an individual who has been given a commission
CBBC	BBC children's television strand for older children aged from 6 to 12
Harland and Wolff	Northern Irish heavy industrial company
Take-Two Interactive	major American publisher, developer, and distributor of video games
No label defined	No description defined
philosophy	study of general and fundamental problems
American Indian Wars	multiple conflicts between American settlers or the federal government and the native peoples of North America
Summit Entertainment	American film production company and distributor
Los Angeles Dodgers	baseball team and Major League Baseball franchise in Los Angeles, California, United States
Lebanon War	1982 war between Israel and forces in Lebanon
MyNetworkTV	American television syndication service
creative writing	No description defined
MCA Records	record company
center	position in basketball
EuropaCorp	No description defined
Colorado Avalanche	hockey team of the National Hockey League
catcher	defensive position in baseball and softball played behind home plate, facing the field
Heather O'Reilly	American professional association football player
Shochiku	Japanese movie studio and production company for kabuki.
Oklahoma City Barons	ice hockey team
Earache Records	record label
Warner Bros. Animation	animation division of Warner Bros. Television Group
EMI Records	record label founded by the EMI company
Kill Rock Stars	U. S. Music-Label
2006 Major League Baseball draft	baseball draft of amateur players by Major League Baseball
Columbus Blue Jackets	hockey team of the National Hockey League
Johnson & Johnson	U.S multinational medical devices, pharmaceutical and consumer packaged goods manufacturer
Ottoman wars in Europe	war
Seven Network	Australian broadcast television network
Arista Records	American record label
Disney Interactive Studios	American video game developer and publisher owned by the Walt Disney Company through Disney Interactive
ESPN	American global cable television network
2005 NFL Draft	No description defined
Delroy Facey	footballer
Springfield Falcons	ice hockey team in the American Hockey League
art of painting	practice of applying paint, pigment, color or other medium to a surface
Paramount Pictures	major film studio in America, specializing in film and television production, and distribution.
CTV Television Network	television station
Wayne Dyer	Montserrat international footballer
Toronto Raptors	professional basketball team based in Toronto, Canada
Dallas Mavericks	American professional basketball team based in Dallas, Texas
Pittsburgh Pirates	baseball team and Major League Baseball franchise in Pittsburgh, Pennsylvania, United States
TV Tokyo	television station
War of the Austrian Succession	war
1996 NCAA Men's Division I Basketball Tournament	No description defined
Pan Am	1927-1991 airline in the United States, former primary international carrier
Universal Motown Records	record label that operated as a division of Universal Motown Republic Group
Jean-Claude Van Damme	Belgian actor, martial artist, director
burgundy	dark red color associated with the Burgundy wine
Swedish	North Germanic language
BBC	British public service broadcaster
performing arts	art forms in which artists use their body or voice to convey artistic expression
Fueled By Ramen	American record label
2007 NBA Draft	No description defined
Pfizer	American multinational pharmaceutical corporation
Tim Duncan	American basketball player
Lars Hirschfeld	Canadian soccer player
punter	position in American and Canadian football
Tight end	position in American football
racism	form of race, ethnic or religion-based discrimination
Caroline Records	record label
Verizon	American broadband and telecommunications company
Verve Records	record label
forward	ice hockey position
Minnesota Twins	baseball team and Major League Baseball franchise in Minneapolis, Minnesota, United States
Bridgeport Sound Tigers	ice hockey team
Lufthansa	airline, former flag-carrier of Germany
AT&T	American multinational telecommunications corporation
Hensley Meulens	Baseball player
Kannada	Dravidian language of India
Hershey Bears	ice hockey team
psychology	study of mental functions and behaviours
midfielder	association football position played on both ends of the field
Daniel Nestor	Canadian tennis player
Taiwo Atieno	Association football forward
Tyra Banks	American model, author and television personality
Toronto Argonauts	professional football team based in Toronto, Canada
Sierra Entertainment	former video game developer and publisher company
Dimension Films	No description defined
Capitol Records	American record label
Qantas	the flag carrier airline of Australia
Indiana Pacers	basketball team in the National Basketball League
Channel 4	British public-service television broadcaster; TV channel
Hiroshima Toyo Carp	Nippon Professional Baseball team in the Central League
St. Louis Blues	hockey team of the National Hockey League
David Carney	Australian soccer player
Acclaim Entertainment	defunct game developer and publisher
Tim Daly	American actor, director and producer
Dean Saunders	Welsh footballer and manager
Mohamed Kallon	Sierra Leonean footballer
American Zoetrope	No description defined
small forward	one of the five positions in a regulation basketball game
New World Pictures	No description defined
California Golden Bears football	college football team
Lakeshore Entertainment	film production company
Comedy Central	American cable and satellite television channel
Seol Ki-hyeon	South Korean footballer
Jeff Garcia	American football player
Yomiuri Giants	Nippon Professional Baseball team in the Central League
SPV	German music label
Indianapolis Colts	National Football League franchise in Indianapolis, Indiana
Oakland Raiders	National Football League franchise in Oakland, California
Toronto Maple Leafs	Canadian professional ice hockey team
Swan Hunter	shipbuilding design, engineering and management company
Michael O'Neill	footballer
News Corporation	media corporation
Marcia Wallace	American actress
ABC Records	American record label founded in New York City in 1955
Cleveland Cavaliers	professional basketball team based in Cleveland, Ohio
Pye Records	British record label
Chicago Bulls	American professional basketball team
Xerox	American document management corporation
Target Corporation	discount department store chain in the United States
Associated Press	American multinational nonprofit news agency
Detroit Tigers	baseball team and Major League Baseball franchise in Detroit, Michigan, United States
Virgin Group	British multinational branded venture capital conglomerate
Punjabi	Indo-Aryan language
Houston Astros	baseball team and Major League Baseball franchise in Houston, Texas, United States
artificial intelligence	branch of computer science that develops machines and software with human-like intelligence
Robbie Keane	Irish footballer
Square Enix	Japanese video game developer, publisher, and distribution company
Gary Sheffield	American professional baseball outfielder
English literature	No description defined
Boeing 737	airliner family; most produced jet airliner in the world
2003 Major League Baseball draft	baseball draft of amateur players by Major League Baseball
Spyglass Entertainment	American film production company founded in 1998
Carlos Ruiz	professional soccer player
2005 Major League Baseball draft	baseball draft of amateur players by Major League Baseball
IFC Films	American film distribution company
Bandai Namco Entertainment	Japanese video game company
Showtime	American premium cable TV channels
Indian Rebellion of 1857	series of mutinies and rebellions against the British East India Company in parts of India
Coalition Wars	No description defined
TriStar Pictures	No description defined
marketing	activities to gain and keep customers, providing value to them through offerings and communication about offerings
Gameloft	A developer of games for mobile phones and tablets
Amblin Entertainment	American film and television production company
HTC Corporation	Taiwanese electronics company
Castle Rock Entertainment	No description defined
Chiba Lotte Marines	Nippon Professional Baseball team in the Pacific League
2005 NBA Draft	No description defined
Edward Woodward	English actor
blue	color; additive and subtractive (RYB) primary color; visible between purple and green
Sicilian Mafia	No description defined
PolyGram Filmed Entertainment	No description defined
Hanshin Tigers	Nippon Professional Baseball team in the Central League
Codemasters	company that develops video games
winger	ice hockey position
Vertigo Records	British record label
Washington Wizards	basketball team
Montreal Alouettes	Canadian Football team
Hameur Bouazza	footballer
Midway Games	former American video game developer and publisher
HAL Laboratory	Japanese video game developer
Caesars Entertainment Corporation	company
NBA Rookie of the Year Award	award
Hindi	language
Westfield Group	Australian shopping centre group
JPMorgan Chase	American multinational banking and financial services holding company
War of 1812	32-month military conflict between the United States and the British Empire
Cooking Vinyl	music label in the UK
Washington Capitals	hockey team of the National Hockey League
Thai	language spoken in Thailand
2006 NCAA Men's Division I Basketball Tournament	No description defined
management	coordinating the efforts of people
Icon Productions	American production company
Lebanese Civil War	civil war
Activision Blizzard	video game publisher
Tamil	language
Silver Pictures	American film production company
Sunsoft	Japanese video game developer
Chunichi Dragons	professional baseball team in the Central League of Nippon Professional Baseball
Tokyo Broadcasting System Holdings	Japanese radio & TV holding company
Image Entertainment	No description defined
2008 NFL Draft	No description defined
Rickey Henderson	American professional baseball player, outfielder, coach
ecology	scientific study of the relationships between living organisms
TV5 (Philippines)	TV channel in the Philippines
Urdu	national language and lingua franca of Pakistan, Nepal and India
Colorado Rockies	baseball team and Major League Baseball franchise in Denver, Colorado, United States
Telugu	Dravidian language
division	distinct and large part of a company
Portuguese	Romance language
Death Row Records	record label
Mario Kassar	American film producer
Andrew G. Vajna	Hungarian film producer
Ben Sahar	footballer
Ryanair	Irish low-cost airline
association football player	person who plays association football (soccer)
Houssine Kharja	French footballer
Brooklyn Nets	Professional basketball team based in the New York City borough of Brooklyn
Rory Fallon	New Zealand footballer
Pre-Raphaelite Brotherhood	group of English painters, poets, and critics, founded in 1848
Jack Kemp	American football player, quarterback, U.S. Congressman
General Growth Properties	American real estate investment trust
BBC HD	high-definition television channel
Second Sino-Japanese War	war between the Republic of China and the Empire of Japan from 1937 to 1945
civil engineering	engineering discipline that deals with construction
Mongol conquests	series of expeditionary wars, invasions and conquests, resulting in the vast Mongol Empire
General Dynamics	defense manufacturing conglomerate
Entertainment One	international entertainment corporation
green	color; additive primary color; visible between blue and yellow
defender	association football position played near the player's team's own goal
Hammer Film Productions	No description defined
Working Title Films	British film production company
international relations	relationships between two or more States
1997 NCAA Men's Division I Basketball Tournament	No description defined
Seoul Broadcasting System	South Korean television and radio network
Miramax	American entertainment company
The Cannon Group	company
Universal Music Group	American music corporation
anthropology	science of humanity
Magic Johnson	American professional basketball player
San Francisco 49ers	American football team in the National Football League
20th Century Fox Home Entertainment	No description defined
library science	field that applies the practices, perspectives, and tools of management, information technology, education, and other areas to libraries
San Diego Padres	baseball team and Major League Baseball franchise in San Diego, California, United States
brown	color
gold medal	medal, generally awarded for first place or a high achievement
Discovery Channel	American basic cable and satellite television channel
J Records	American record label
Alou Diarra	French footballer
Decca Records	US/British record label
film	sequence of images that give the impression of movement
EMI	British music recording and publishing company
gold	color
Syfy	American cable television channel
Carl Weathers	actor; Former American Football Player
LeBron James	American professional basketball player
THINKFilm	defunct U.S. film distribution company
Western Front (World War I)	main theatre of war during the First World War
The WB	defunct American broadcast TV network followed by defunct Internet-only service
California Department of Parks and Recreation	No description defined
Sports Illustrated Sportsperson of the Year	annual honor presented by the American magazine Sports Illustrated
UK Film Council	organization
Enix	Japanese video game publisher
Philadelphia Phillies	baseball team and Major League Baseball franchise in Philadelphia, Pennsylvania, United States
Elektra Records	record company and music label
Tribune Media	American media conglomerate
French	Romance language
Yue Chinese	primary branch of Chinese spoken in southern China
Adobe Systems	American multinational computer software company
Interscope Records	American record label
industrial engineering	branch of engineering which deals with the optimization of complex processes or systems
Jonathan Walters	Irish footballer
Curb Records	American record label
Origin Systems	former video game developer based in Austin, Texas
Artisan Entertainment	American movie studio
Kevin Garnett	American retired professional basketball player
easyJet	British airline
Koch Entertainment	American media company
Bravo	American basic cable and satellite television channel
Atlanta Thrashers	No description defined
Manchester Monarchs	former ice hockey team in the American Hockey League
Jermaine Easter	footballer
Philadelphia Eagles	American football team
Leander Paes	Indian tennis player
power forward	position in the sport of basketball
TV Asahi	Japanese television network
The Walt Disney Company	American diversified multinational mass media corporation
Scott McDonald	Australian soccer player
administration	management of organization
Sun Microsystems	defunct computer hardware and software company which was based in Santa Clara
Food Network	American TV channel
Philadelphia Flyers	professional ice hockey team
Sprint Corporation	US American telecommunication company
Vivendi Games	No description defined
geology	scientific discipline
American Broadcasting Company	American broadcast television network owned by The Walt Disney Company through Disney-ABC Television Group
CNN	American-based news channel
1995 NCAA Men's Division I Basketball Tournament	No description defined
2008 NCAA Men's Division I Basketball Tournament	No description defined
2007 NCAA Men's Division I Basketball Tournament	No description defined
Motorola	telecommunications company
Lockheed Martin	aerospace and defense manufacturer, largest defense contractor in the world
Boston Red Sox	baseball team and Major League Baseball franchise in Boston, Massachusetts, United States
gray	intermediate color between black and white; color of a cloud-covered sky, ash and lead
Albany Devils	No description defined
New York Jets	National Football League franchise in East Rutherford, New Jersey
Junichi Inamoto	Japanese footballer
Thirty Years' War	series of wars principally fought in Central Europe
German-Soviet War	theatre of World War II - war between Germany and USSR 1941-1945
Chris Killen	New Zealand footballer
red	color
Century Media Records	record label
Alpha Sigma Phi	No description defined
Tagalog	Austronesian language
KLM	flag carrier airline of the Netherlands
Scots	Germanic language
2003 NBA Draft	No description defined
Relativity Records	record label
2000 NCAA Men's Division I Basketball Tournament	No description defined
Yahoo	American multinational corporation
Paramount Vantage	specialty film division of Paramount Pictures
Philips Records	record label
Napoleonic Wars	series of wars between Napoleon's French Empire and the 2nd to the 7th coalition of European powers
Dallas Stars	ice hockey team of the National Hockey League
architecture	both the process and product of planning, designing and construction
Sinclair Broadcast Group	American media company
BYU Cougars football	No description defined
505 Games	video game publishing division of Digital Bros
Hearst	American multinational conglomerate group
Boston Celtics	American professional basketball team in the National Basketball Association
2003 NFL Draft	No description defined
American Civil War	19th-century conflict in the United States
biochemistry	study of chemical processes in living organisms
Ronaldo	Brazilian footballer
Norwegian	language spoken in Norway
Lifetime	American cable and satellite television
Austronesian languages	language family of Southeast Asia and the Pacific
Terry Crews	American football player and actor
IBM	American multinational technology and consulting corporation
New York Giants	professional American football team
2003 invasion of Iraq	start of the conflict known as the Iraq War
Leo Bertos	New Zealand professional footballer
physics	study of matter and its motion, along with related concepts such as energy and force
2K Games	developer, marketer, distributor and publisher of software games
The New York Times Company	American media company, publisher of The New York Times
Chris Paul	American professional basketball player
Miami Marlins	baseball team and Major League Baseball franchise in Miami, Florida, United States
Republic Pictures	No description defined
Network Ten	Australian television network
finance	study of how people allocate their assets
Theofanis Gekas	Greek footballer
John Ruddy	English footballer
Blue Note Records	American record label
Ukrainian	member of the East Slavic subgroup of the Slavic languages
center fielder	defensive position in baseball
Adult Swim	American cable network
Candlelight Records	record label
UTV Motion Pictures	No description defined
The Criterion Collection	company
ANTI-	record label
Director-General	title given the highest executive officer in some organisations
German-Soviet War	theatre of World War II - war between Germany and USSR 1941-1945
Gujarati	one of the official languages of India
San Jose Sharks	hockey team of the National Hockey League
drag queen	man who dresses and acts with exaggerated femininity for performance purposes
The McClatchy Company	No description defined
Seattle SuperSonics	professional basketball team in Seattle, Washington, USA  between 1967-2008
Arizona Coyotes	hockey team of the National Hockey League
2010 NCAA Men's Division I Basketball Tournament	No description defined
2006 NBA Draft	No description defined
technology	making, modification, usage, and knowledge of tools, machines, techniques, crafts, systems, and methods of organization
New Line Cinema	American film studio and distributor
Jaleco	Japanese video game publisher and developer
EMI Music Japan	music company
Japanese	East Asian language
Marvel Comics	company that publishes comic books and related media from America
S.M. Entertainment	South Korean music corporation
Defensive end	No description defined
Kevin Betsy	footballer
Casablanca Records	American recording label
Morgan Stanley	company
Nokia	Finnish technology corporation
Warner Music Group	American major global music conglomerate
Canon Inc.	Japanese multinational corporation specialised in the manufacture of imaging and optical products
politics	practice and theory of influencing other people, as in government
Simon Property Group	American commercial real estate  company and real estate investment trust
Fox Kids	Fox Broadcasting Company's American children's programming division
Metal Blade Records	record label
Atco Records	record label
American Airlines	major airline of the United States
Albanian	Indo-European language
Khmer	language spoken in Cambodia
Jim Brown	American former professional football player and current special advisor to the Cleveland Browns
BBC News	BBC department responsible for the gathering and broadcasting of news and current affairs
National Football League Most Valuable Player Award	award
The Coca-Cola Company	American multinational beverage corporation
Lucasfilm	American film and television production company
designated hitter	offensive position in baseball and softball
Los Angeles Rams	football franchise from the United States
Citigroup	company
biology	study of life
New York Knicks	professional basketball team based in New York City, New York.
Milwaukee Bucks	American professional basketball team
Shane Smeltz	New Zealand footballer
Genentech	biotech company
English Civil War	series of armed conflicts and political machinations between Parliamentarians and Royalists
Rose Bowl Game	American college football tournament
Anaheim Ducks	hockey team of the National Hockey League
Phoenix Suns	American professional basketball team
lineman	American football player who specializes in play at the line of scrimmage
Persian	Indo-European language
Maxis	US video game developer
eBay	American multinational internet corporation that manages eBay.com
U.S. Gold	British video game publisher and developer
Sony Music Entertainment Japan	Japanese record label
Welsh	Brythonic language spoken natively in Wales
National Film Board of Canada	Canada's public film and digital media producer and distributor
United States presidential election, 2008	56th quadrennial presidential election
Montreal Expos	former baseball team in Montreal, Canada, predecessor of the current Washington Nationals
Los Angeles International Airport	airport serving the Greater Los Angeles Area
Reprise Records	American record label
Sequoia Capital	No description defined
Happy Madison	American film/television production company
Spanish	Romance language
2001 Major League Baseball draft	baseball draft of amateur players by Major League Baseball
political philosophy	sub-discipline of philosophy and political science
Cleveland Browns	National Football League franchise in Cleveland, Ohio
Green Bay Packers	American football team
Freeform	US television station
Warner Bros. Interactive Entertainment	publisher, developer, licensor, and distributor of video games
Hollywood Records	Music label in the USA
CBS	American broadcast television network
applied mathematics	discipline of mathematics
Atari	Corparate and brand name
Boeing	American aerospace and defence manufacturer
Tampa Bay Lightning	hockey team of the National Hockey League
privately held company	type of business entity
Vanguard Records	No description defined
Rogue	American film production company
Google	American multinational Internet and technology corporation
Play It Again Sam	independent record label
Carolina Hurricanes	hockey team of the National Hockey League
Detroit Red Wings	hockey team of the National Hockey League
Golden State Warriors	American professional basketball team from 1946
Alex Rodriguez	baseball player
Los Angeles Clippers	basketball team in Los Angeles, California, United States
Serena Williams	American tennis player
Minnesota Vikings	American football team
white	color
Didier Six	French footballer
1985 NCAA Men's Division I Basketball Tournament	No description defined
Avex Trax	record label owned by Japanese entertainment conglomerate Avex Group
Beggars Banquet Records	British independent record label
Jeff Gordon	American racing driver
CNBC	American basic cable and satellite business news television channel
Natsume	Japanese video game company
The Island Def Jam Music Group	record label
Bertelsmann Music Group	record label company
Minnesota Timberwolves	professional basketball team
Universal Studios	American motion picture studio
Atlus	Japanese video game developer
Long snapper	No description defined
SkyTeam	global airline alliance
Disney Channel	US youth-targeted television channel owned by the Walt Disney Company
Keith Andrews	Irish footballer
Gannett Company	American newspaper publishing corporation
Constantin Film	No description defined
Michael Phelps	American swimmer
Virgin Interactive	Former British video game publisher
THQ	video game publisher
Craig Bellamy	footballer
orange	color, takes its name from the orange fruit, located between red and yellow in the spectrum of light
StudioCanal	French film production and distribution company
first baseman	defensive position in baseball and softball, played on the far right side of the infield at or near first base
I.R.S. Records	American record label
Sinhala	language of the Sinhalese people of Sri Lanka
HBO Films	film production company
2007 NFL Draft	No description defined
Detroit Lions	American football team in the National Football League
Sub Pop	American record label
Spike	American cable and satellite channel owned by Viacom through Viacom Media Networks
San Antonio Spurs	American professional basketball team based in San Antonio, Texas
Stephen Jackson	American basketball player
Electronic Arts	American interactive entertainment company
VH1	American cable television network
Utah Jazz	professional basketball team based in Salt Lake City, Utah
North African Campaign	military campaign of World War II
MSNBC	American television station specialising in news and information
1991 NCAA Men's Division I Basketball Tournament	No description defined
starting pitcher	baseball or softball pitcher who throws the first pitch for their team in a game
2008 NBA Draft	No description defined
Ross Turnbull	English footballer
Macy's, Inc.	is an American holding company headquartered in Cincinnati, Ohio. It is the owner of department store chains Macy's and Bloomingdale's.
Jackie Robinson	American baseball player
St. John's IceCaps	No description defined
Australian English	language
PBS	public television network in the United States
Providence Bruins	ice hockey team
silver medal	Medal awarded in sports and other competitions
Orion Pictures	film production company in United States of America
Finnish	language arising and mostly spoken in Finland, of the Finnic family
John Madden	U.S. American football player and coach
Boeing 747	airliner family, first wide-body to be produced, largest airliner in production for nearly 40 years
Mattel	American toy company
NCAA Basketball Tournament Most Outstanding Player	No description defined
Russian Civil War	multi-party war in the former Russian Empire, November 1917-October 1922
First War of Scottish Independence	war between English and Scottish forces
Chris Nurse	English footballer
Heather Mitts	American soccer player, Olympic gold medalist
Los Angeles Chargers	National Football League franchise in Los Angeles, California
History	US-based international satellite and cable TV channel
Derek Jeter	baseball player from the United States
Memphis Grizzlies	American professional basketball team based in Memphis, Tennessee
Houston Rockets	American professional basketball team based in Houston, Texas
MTV2	American cable and satellite television channel spun off of MTV
Hasbro, Inc.	toy and media company
Greek	language spoken in Greece and Cyprus
second baseman	defensive position in baseball and softball, played on the right side of the infield near second base
1989 NCAA Men's Division I Basketball Tournament	No description defined
Tommy Boy Records	American independent record label
Northrop Grumman	aerospace and defense technology corporation
Alternative Tentacles	American record label
Hamilton Bulldogs	ice hockey team in the American Hockey League
1988 NCAA Men's Division I Basketball Tournament	No description defined
Houston Texans	National Football League franchise in Houston, Texas
Filipino language	official language of the Philippines
Croatian	South Slavic language
goaltender	person who blocks the goal in ice hockey
Yiddish	language used by Ashkenazi Jews
Columbia Pictures	American film production and distribution studio
Second Crusade	second major crusade launched from Europe as Catholic ('Latin') Holy War against Islam
Delta Air Lines	airline in the United States of America
The New York Times	American daily newspaper
K Records	an independent record label in Olympia, Washington
Sony Pictures Entertainment	American television and film production and distribution unit of Sony
Arabic alphabet	Arabic script as it is codified for writing the Arabic language
Miami Dolphins	National Football League franchise in Miami, Florida
New York Rangers	hockey team of the National Hockey League
First Crusade	pilgrimage and military expedition by Roman Catholic Europe to Holy Lands
Novak Djokovic	Serbian tennis player
The CW	American broadcast television network
Gap, Inc.	American multinational clothing and accessories retailer
Fortune 1000	No description defined
Amtrak	intercity rail operator in the United States
Polish	language spoken in Poland
outfielder	defensive position in baseball
Walt Disney Studios Motion Pictures	American motion picture distribution company
Leon Cort	footballer
pitcher	in a game of baseball, or softball the player responsible to throwing ("pitching") the ball to the batters
Edmonton Oilers	hockey team of the National Hockey League
Star Cinema	Filipino film & television production company & film distributor
Calgary Flames	hockey team of the National Hockey League
Nettwerk	Music Publisher
AOL	internet company, e-mail service provider
Middle Eastern theatre of World War I	scene of action between 29 October 1914, and 30 October 1918
Kentucky Wildcats men's basketball	No description defined
Chinese Civil War	1927-1950 civil war in China
Chrysalis Records	British music label
cornerback	defensive position in American and Canadian football
Taliban insurgency	insurgency during the War in Afghanistan
Klaas-Jan Huntelaar	Dutch footballer
mechanical engineering	discipline of engineering
Universal Republic Records	record label
Houston Aeros	No description defined
Davis Entertainment	American film production company
Denver Nuggets	professional basketball team based in Denver, Colorado
Rockstar Games	multinational video game developer and publisher
Dwyane Wade	American basketball player
Heisman Trophy	annual award for outstanding college football player
Marvel Entertainment	company
Scott Bradley	American composer
Bethesda Softworks	American video game publisher
iHeartMedia	American mass media corporation
Konami	Japanese company
Olympiacos B.C.	basketball team
Alex Manninger	Austrian footballer
French and Indian War	the North American theater of the worldwide Seven Years' War
BBC Films	film production company
2004 NCAA Men's Division I Basketball Tournament	No description defined
BBC One	flagship television channel of the BBC
GMA Network	commercial television network in the Philippines
Third Crusade	attempt by European leaders to reconquer the Holy Land from Saladin
Indonesian	language spoken in Indonesia
Delta Delta Delta	No description defined
Operation Barbarossa	Germany's invasion of the Soviet Union during World War II
Epic Records	American record company
Tom Brady	American football player, quarterback
Chicago Bears	American football team
telecommunication	transmission of information between locations using electromagnetics
Carolina Panthers	American football team
Hamilton Tiger-Cats	Canadian Football League team from Hamilton, Ontario
Hungarian	language spoken in and around Hungary
Hollywood Pictures	No description defined
Columbia blue	No description defined
MGM Resorts International	gaming, hospitality and entertainment company
Mercury Records	USA record label
Connecticut Whale	ice hockey team
Gaumont Film Company	French film studio
Six-Day War	1967 war between Israel and Egypt, Jordan, and Syria
political science	social science concerned with the study of politics and political systems
National Football League	a professional American football league consisting of 32 teams
CBC Television	public broadcaster
Jung Sung-ryong	South Korean footballer
television	telecommunication medium for transmitting and receiving moving images
Fine Line Features	film production company
Walt Disney Studios Home Entertainment	Walt Disney Company's home video division
Rare Ltd.	video game developer
Mandopop	music genre
Gallipoli campaign	military campaign during World War I
Chrysler	automotive brand manufacturing subsidiary of Fiat Chrysler Automobiles
zoology	study of the animal kingdom
Landon Donovan	American soccer player
Oakland Athletics	baseball team and Major League Baseball franchise in Oakland, California, United States
Joshua Kennedy	Australian soccer player
dance	creative work whose interpretation generally involves movement of the body
Calgary Stampeders	Canadian football team
Vivendi	French media company
relief pitcher	baseball or softball pitcher who relieves a previous pitcher
WWE	professional wrestling and entertainment company
scarlet	color shade of bright red
Doug Flutie	All-American college football player, professional football player, quarterback, College Football Hall of Fame member, Heisman Trophy winner
terrorism	use of violence as a form of political, economic and religious coercion
Hulk	Brazilian footballer
Global Television Network	television station
sociology	scientific study of human society and its origins, development, organizations, and institutions
Ricardo Fuller	footballer
art of sculpture	branch of the visual arts that operates in three dimensions
Giovani dos Santos	Mexican footballer
Zetima	Japanese record label
electrical engineering	field of engineering that deals with electricity
Sony	Chinese multinational conglomerate corporation
Russian	Slavic language
PolyGram	label recording company
James G. Robinson	American film producer
Oracle Corporation	American multinational computer technology corporation
English studies	academic discipline
Virgin Records	English record label
Wii	home video game console produced by Nintendo in 2006
Creation Records	record label
Mandarin Chinese	group of related varieties or dialects spoken across most of northern and southwestern China
1986 NCAA Men's Division I Basketball Tournament	No description defined
Geffen Records	American record label
Daybreak Game Company	video game developer and publisher
New Jersey Devils	hockey team of the National Hockey League
Sony Interactive Entertainment	American video game subsidiary of Sony
2009 NCAA Men's Division I Basketball Tournament	No description defined
Sony BMG	former recorded music company
SNK Playmore	Japanese video game company
Cold War	opposites between the USA and the USSR with allies between 1945-1991
Roadrunner Records	record label
poetry	form of literary art
Ariola Records	German record label
War of the Fourth Coalition	part of the Napoleonic Wars
Procter & Gamble	American multinational consumer goods company
Arabic	Semitic language
Invasion of Normandy	invasion and establishment of Western Allied forces in Normandy during WWII
STV	television channel in Scotland
UTV	television broadcaster in Northern Ireland
biotechnology	use of living systems and organisms to develop or make useful products
Detroit Pistons	professional basketball team based in Detroit
Fontana Records	American record label
Bank of America	American multinational banking and financial services corporation
Capcom	Japanese developer and publisher of video games
Liberty Records	American record label
science	study and knowledge
Mark Bresciano	Australian soccer player
evolution	change in the inherited characteristics of biological populations over successive generations
Maccabi Tel Aviv B.C.	basketball team
wide receiver	offensive position in American and Canadian football
ethics	Branch of philosophy that involves systematizing, defending, and recommending concepts of right and wrong conduct
agriculture	cultivation of life forms for food, fiber, biofuel and other products used to sustain life
engineering	application of knowledge to produce systems
Cartoon Network	American cable television network
astronomy	natural science that deals with the study of celestial objects
Swahili	Bantu language
San Francisco Giants	baseball team and Major League Baseball franchise in San Francisco, California, United States
American Hockey League	ice hockey league in the United States
Kickoff returner	No description defined
literature	written work of art
Indo-Pakistani War of 1971	conflict between the two nuclear powers alongside the Bangladesh Liberation War
CBC Television	Canadian television network
Carl Cort	Footballer
geography	study of the lands, features, inhabitants, and phenomena of the Earth and other beings
First Indochina War	war in French Indochina from 1946 to 1954
women's studies	interdisciplinary academic field that explores politics, society, media, and history from women's and/or feminist perspectives
Magnolia Pictures	No description defined
Washington Redskins	American football team
Battle of France	successful German invasion of France
Western Desert Campaign	one of two major stages of the North African Campaign during WWII
Atlanta Hawks	American professional basketball team based in Atlanta, Georgia
airliner	aircraft designed for commercial transportation of passengers and cargo
New Orleans Pelicans	American professional basketball team based in New Orleans, Louisiana
Reliance Entertainment	No description defined
E. W. Scripps Company	company
Battle of Passchendaele	campaign of the First World War
Dutch	West Germanic language
American International Pictures	film production company
education	learning in which knowledge and skills is transferred through teaching
Channel 5	British TV station
Canadian English	dialect within the English language
Oklahoma Sooners football	football team of the University of Oklahoma
New York Islanders	hockey team of the National Hockey League
West Virginia Mountaineers football	American college football team
Baltimore Ravens	National Football League franchise in Baltimore,  Maryland
General Electric	American multinational conglomerate corporation
MCA Inc.	corporation
Chicago White Sox	baseball team and Major League Baseball franchise in Chicago, Illinois, United States
Seven Years' War	world war between 1756 and 1763
Syracuse Crunch	ice hockey team
Boaz Myhill	footballer
Irish	language spoken in Ireland
infielder	defensive position in baseball
Kids' WB	American children's programming block
FromSoftware	Japanese video game developer
Turkish	Turkic language (possibly Altaic)
Brad Jones	Australian association football player
CBS Records	No description defined
Nintendo	Japanese multinational video game and consumer electronics company
GT Interactive Software	company
Chinese	family of languges
Starbucks	American multinational coffee company
Sympathy for the Record Industry	No description defined
Philips	Dutch multinational electronics company
Stax Records	record label
RCA	American electronics company
New Orleans Saints	American football team
New England Patriots	National Football League franchise in Foxborough, Massachusetts
civil war	war between organized groups within the same sovereign state or republic
Nonesuch Records	American record label, owned by Warner Music Group, and based in New York City
Frontiers Records	record label
Romanian	Romance language
Orlando Magic	American professional basketball team based in Orlando, Florida
2008 NFL season	89th season in the history of the National Football League
Ki Sung-yueng	South Korean footballer
Cash Money Records	American record label founded by brothers Bryan "Birdman" Williams and Ronald "Slim" Williams
Duke Blue Devils men's basketball	college men's basketball team representing Duke University
Lookout! Records	record label
Marc Joseph	footballer
Montreal Canadiens	National Hockey League team in Montreal, Quebec, Canada
Imperial Records	No description defined
Sky 1	television channel
Sanctuary Records Group	No description defined
Bandai Namco Holdings	Japanese holding company
MicroProse	American video game company
2006 NFL Draft	No description defined
Afrikaans	West Germanic language
Oklahoma City Thunder	professional basketball team based in Oklahoma City, Oklahoma
Samsung Electronics	South Korean multinational electronics company
defenceman	position in ice hockey
Motown Records	American music record company
Bounce TV	American digital multicast television network
Shanachie Records	Independent record label based in United States
limited liability company	flexible form of enterprise in the US
Bob Bryan	American tennis player
Battle of the Somme	Battle of the Western Front, World War I
business enterprise	organization involved in the trade of goods, services, or both to customers for pay
Sparrow Records	American record label
Richard Roundtree	American actor
Southwest Airlines	airline in the United States
Abidjan	city and the former official capital of Ivory Coast
statistics	study of the collection, organization, analysis, interpretation, and presentation of data
Western Front (World War II)	European Theatre of World War II
Ferret Music	record label
Vinnie Jones	British actor and former professional footballer
CBS Corporation	American mass media corporation
CITV	British television channel
Miami Heat	American professional basketball team
Giuseppe Colucci	Italian footballer
Omaha Nighthawks	No description defined
subsidiary company	company that is completely or partly owned and partly or wholly controlled by another company
Falklands War	1982 war between Argentina and the United Kingdom
Juan Mata	Spanish footballer
software engineering	application of systematic approaches to developing software
Backbone Entertainment	No description defined
music video	short film integrating a song and imagery
Def Jam Recordings	record label
Ninja Tune	British independent record label based in London
ABS-CBN	commercial television network in the Philippines
RCA Records	American recording label
Korean War	1950-1953 war on the Korean Peninsula during the Cold War
Media Asia Entertainment Group	No description defined
corporation	separate legal entity that has been incorporated through a legislative or registration process established through legislation
Touchstone Pictures	American film production company
David Healy	footballer
Pixar	American computer animation studio
MGM Records	American record label
Bulgarian	South Slavic language
Island Records	American record label, a division of Universal Music Group
Black Entertainment Television	television station
history	umbrella term covering the record of past events
Venus Williams	American tennis player
Halfback	No description defined
United Artists Records	American record label
advertising	form of communication for marketing, typically paid for
Screen Gems	No description defined
Moses Ashikodi	footballer
Chicago Blackhawks	hockey team of the National Hockey League
Ubisoft	French multinational video game developer and publisher
Baltimore Orioles	baseball team and Major League Baseball franchise in Baltimore, Maryland, United States
4AD	record label
General Motors	automotive manufacturing corporation based in Detroit, Michigan, USA
General Dynamics Electric Boat	subsidiary of General Dynamics Corporation
Czech	West Slavic language spoken in the Czech Republic
Placekicker	No description defined
Majesco Entertainment	company
New York Mets	baseball team and Major League Baseball franchise in Queens, New York, United States
aviation	design, development, production, operation and use of aircraft
DreamWorks Records	American record label
Charlotte Hornets	American professional basketball team based in Charlotte, North Carolina
defensive back	position in American football
Jonathan Forte	footballer
Toronto Blue Jays	baseball team and Major League Baseball franchise in Toronto, Ontario, Canada
Ray Allen	American basketball player
neuroscience	scientific study of the nervous system
1997 Major League Baseball draft	baseball draft of amateur players by Major League Baseball
Neymar Jr	Brazilian footballer
Asylum Records	record label
Toho	Japanese film production company
Citadel Broadcasting	No description defined
1998 NCAA Men's Division I Basketball Tournament	No description defined
Fred Williamson	American football player and actor
information technology	development, management, and use of computer-based information systems
college basketball	No description defined
Pittsburgh Steelers	National Football League franchise in Pittsburgh, Pennsylvania
the Holocaust	programme of systematic state-sponsored murder by Nazi Germany
Carmelo Anthony	American professional basketball player
Warner Bros. Records	American record label
Cleveland Indians	baseball team and Major League Baseball franchise in Cleveland, Ohio, United States 2017 American League Central Division Champions
Dell Inc.	American multinational computer technology corporation
shooting guard	position on a basketball team
Tampa Bay Rays	baseball team and Major League Baseball franchise in St. Petersburg, Florida, United States
Maverick Records	No description defined
Bengali	language native to the region of eastern South Asia known as Bengal
Jonas Brothers World Tour 2009	concert tour
Strategic Simulations, Inc.	video game developer
Walt Disney Imagineering	Disney Parks R&D department
PopCap Games	No description defined
print	work of art produced by a printing process
Deram Records	british music label
Mike Bryan	American tennis player
Revolution Studios	American production company
public health	science and art of preventing disease, prolonging life and promoting health through organized efforts and informed choices of society, organizations, public and private, communities and individuals
logic	study of inference and demonstration
Rykodisc	record label
Tecmo	No description defined
LucasArts	American video game producer and publisher
Chris Waddle	English footballer
NCAA Men's Division I Basketball Championship	basketball tournament
Fox Broadcasting Company	American television network
King Records	Japanese record company
The End Records	No description defined
Latin	Indo-European language of the Italic family
London Records	record label headquartered in the United Kingdom
Fortune 500	company
2001 NCAA Men's Division I Basketball Tournament	No description defined
Iraq War	war which started on 20 March 2003
Florida Panthers	hockey team of the National Hockey League
E!	American television network
2003 NCAA Men's Division I Basketball Tournament	No description defined
Universal Studios Home Entertainment	No description defined
German	West Germanic language
Italian	Romance language
Valve Corporation	American video game development and digital distribution company
Jason Kidd	American basketball player and coach
public administration	public leadership of public affairs directly responsible for executive action
